KOD TERYTORIALNY;Gmina;Powiat;Delegatura;Liczba mieszkańców;Liczba wyborców ogółem;Liczba wyborców wpisanych z urzędu;Liczba wyborców ujętych w stałym obwodzie w CRW na wniosek
Powiat bolesławiecki;;;;85788;69865;69381;484
020101;m. Bolesławiec;bolesławiecki;Jelenia Góra;36307;30221;30142;79
020102;gm. Bolesławiec;bolesławiecki;Jelenia Góra;14136;11303;11255;48
020103;gm. Gromadka;bolesławiecki;Jelenia Góra;5331;4392;4256;136
020104;gm. Nowogrodziec;bolesławiecki;Jelenia Góra;14827;11804;11759;45
020105;gm. Osiecznica;bolesławiecki;Jelenia Góra;6704;5374;5246;128
020106;gm. Warta Bolesławiecka;bolesławiecki;Jelenia Góra;8483;6771;6723;48
Powiat dzierżoniowski;;;;96754;80863;80415;448
020201;m. Bielawa;dzierżoniowski;Wałbrzych;28720;24340;24218;122
020202;m. Dzierżoniów;dzierżoniowski;Wałbrzych;31146;26113;26059;54
020203;m. Pieszyce;dzierżoniowski;Wałbrzych;9110;7488;7363;125
020204;m. Piława Górna;dzierżoniowski;Wałbrzych;6051;5044;5023;21
020205;gm. Dzierżoniów;dzierżoniowski;Wałbrzych;8999;7374;7360;14
020206;gm. Łagiewniki;dzierżoniowski;Wałbrzych;7365;5989;5911;78
020207;gm. Niemcza;dzierżoniowski;Wałbrzych;5363;4515;4481;34
Powiat głogowski;;;;85021;69108;68550;558
020301;m. Głogów;głogowski;Legnica;63162;51917;51709;208
020302;gm. Głogów;głogowski;Legnica;6736;5325;5229;96
020303;gm. Jerzmanowa;głogowski;Legnica;5137;3949;3820;129
020304;gm. Kotla;głogowski;Legnica;4378;3445;3415;30
020305;gm. Pęcław;głogowski;Legnica;2198;1754;1734;20
020306;gm. Żukowice;głogowski;Legnica;3410;2718;2643;75
Powiat górowski;;;;34109;27708;27388;320
020401;gm. Góra;górowski;Wrocław;19222;15609;15523;86
020402;gm. Jemielno;górowski;Wrocław;3024;2426;2387;39
020403;gm. Niechlów;górowski;Wrocław;4737;3853;3799;54
020404;gm. Wąsosz;górowski;Wrocław;7126;5820;5679;141
Powiat jaworski;;;;49066;40542;40264;278
020501;m. Jawor;jaworski;Jelenia Góra;22073;18573;18498;75
020502;gm. Bolków;jaworski;Jelenia Góra;10112;8308;8274;34
020503;gm. Męcinka;jaworski;Jelenia Góra;4916;3985;3920;65
020504;gm. Mściwojów;jaworski;Jelenia Góra;4034;3229;3190;39
020505;gm. Paszowice;jaworski;Jelenia Góra;3923;3225;3197;28
020506;gm. Wądroże Wielkie;jaworski;Jelenia Góra;4008;3222;3185;37
Powiat karkonoski;;;;60585;50270;49189;1081
020601;m. Karpacz;karkonoski;Jelenia Góra;4526;3875;3612;263
020602;m. Kowary;karkonoski;Jelenia Góra;10055;8422;8366;56
020603;m. Piechowice;karkonoski;Jelenia Góra;5944;4999;4892;107
020604;m. Szklarska Poręba;karkonoski;Jelenia Góra;5854;5006;4831;175
020605;gm. Janowice Wielkie;karkonoski;Jelenia Góra;4147;3342;3276;66
020606;gm. Jeżów Sudecki;karkonoski;Jelenia Góra;7227;5837;5744;93
020607;gm. Mysłakowice;karkonoski;Jelenia Góra;9734;8022;7909;113
020608;gm. Podgórzyn;karkonoski;Jelenia Góra;7938;6544;6406;138
020609;gm. Stara Kamienica;karkonoski;Jelenia Góra;5160;4223;4153;70
Powiat kamiennogórski;;;;42135;34936;34768;168
020701;m. Kamienna Góra;kamiennogórski;Jelenia Góra;18188;15359;15312;47
020702;gm. Kamienna Góra;kamiennogórski;Jelenia Góra;8891;7040;7001;39
020703;gm. Lubawka;kamiennogórski;Jelenia Góra;10641;8896;8837;59
020704;gm. Marciszów;kamiennogórski;Jelenia Góra;4415;3641;3618;23
Powiat kłodzki;;;;152490;127520;125755;1765
020801;m. Duszniki-Zdrój;kłodzki;Wałbrzych;4371;3742;3647;95
020802;m. Kłodzko;kłodzki;Wałbrzych;24977;21068;20853;215
020803;m. Kudowa-Zdrój;kłodzki;Wałbrzych;9472;7964;7835;129
020804;m. Nowa Ruda;kłodzki;Wałbrzych;21272;18032;17960;72
020805;m. Polanica-Zdrój;kłodzki;Wałbrzych;6149;5312;5119;193
020806;gm. Bystrzyca Kłodzka;kłodzki;Wałbrzych;18088;15148;14878;270
020807;gm. Kłodzko;kłodzki;Wałbrzych;16846;13685;13599;86
020808;gm. Lądek-Zdrój;kłodzki;Wałbrzych;7987;6759;6597;162
020809;gm. Lewin Kłodzki;kłodzki;Wałbrzych;1942;1572;1502;70
020810;gm. Międzylesie;kłodzki;Wałbrzych;7126;5836;5760;76
020811;gm. Nowa Ruda;kłodzki;Wałbrzych;11398;9423;9320;103
020812;gm. Radków;kłodzki;Wałbrzych;8793;7259;7174;85
020813;gm. Stronie Śląskie;kłodzki;Wałbrzych;6960;5904;5748;156
020814;gm. Szczytna;kłodzki;Wałbrzych;7109;5816;5763;53
Powiat legnicki;;;;53346;42973;42273;700
020901;m. Chojnów;legnicki;Legnica;12544;10445;10399;46
020902;gm. Chojnów;legnicki;Legnica;9308;7549;7395;154
020903;gm. Krotoszyce;legnicki;Legnica;3216;2589;2534;55
020904;gm. Kunice;legnicki;Legnica;6682;5283;5134;149
020905;gm. Legnickie Pole;legnicki;Legnica;5121;3873;3769;104
020906;gm. Miłkowice;legnicki;Legnica;6577;5261;5126;135
020907;gm. Prochowice;legnicki;Legnica;7308;5919;5873;46
020908;gm. Ruja;legnicki;Legnica;2590;2054;2043;11
Powiat lubański;;;;52398;43493;43061;432
021001;m. Lubań;lubański;Jelenia Góra;19854;16816;16719;97
021002;m. Świeradów-Zdrój;lubański;Jelenia Góra;3965;3329;3272;57
021003;gm. Leśna;lubański;Jelenia Góra;9764;7963;7867;96
021004;gm. Lubań;lubański;Jelenia Góra;6456;5193;5131;62
021005;gm. Olszyna;lubański;Jelenia Góra;6311;5233;5157;76
021006;gm. Platerówka;lubański;Jelenia Góra;1591;1308;1288;20
021007;gm. Siekierczyn;lubański;Jelenia Góra;4457;3651;3627;24
Powiat lubiński;;;;101345;82931;82082;849
021101;m. Lubin;lubiński;Legnica;68372;56520;56164;356
021102;gm. Lubin;lubiński;Legnica;15749;12434;12252;182
021103;gm. Rudna;lubiński;Legnica;7752;6170;5957;213
021104;gm. Ścinawa;lubiński;Legnica;9472;7807;7709;98
Powiat lwówecki;;;;44313;36913;36462;451
021201;gm. Gryfów Śląski;lwówecki;Jelenia Góra;9310;7861;7824;37
021202;gm. Lubomierz;lwówecki;Jelenia Góra;5816;4789;4665;124
021203;gm. Lwówek Śląski;lwówecki;Jelenia Góra;16714;13798;13681;117
021204;gm. Mirsk;lwówecki;Jelenia Góra;8328;6987;6892;95
021205;gm. Wleń;lwówecki;Jelenia Góra;4145;3478;3400;78
Powiat milicki;;;;36529;29174;28906;268
021301;gm. Cieszków;milicki;Wrocław;4749;3758;3685;73
021302;gm. Krośnice;milicki;Wrocław;8080;6394;6338;56
021303;gm. Milicz;milicki;Wrocław;23700;19022;18883;139
Powiat oleśnicki;;;;103890;83942;83260;682
021401;m. Oleśnica;oleśnicki;Wrocław;35309;28910;28690;220
021402;gm. Bierutów;oleśnicki;Wrocław;9758;8045;7972;73
021403;gm. Dobroszyce;oleśnicki;Wrocław;6714;5278;5175;103
021404;gm. Dziadowa Kłoda;oleśnicki;Wrocław;4585;3590;3567;23
021405;gm. Międzybórz;oleśnicki;Wrocław;5045;4002;3964;38
021406;gm. Oleśnica;oleśnicki;Wrocław;13422;10551;10449;102
021407;gm. Syców;oleśnicki;Wrocław;16358;13214;13151;63
021408;gm. Twardogóra;oleśnicki;Wrocław;12699;10352;10292;60
Powiat oławski;;;;73680;59529;58891;638
021501;m. Oława;oławski;Wrocław;31267;25460;25285;175
021502;gm. Domaniów;oławski;Wrocław;5192;4171;4103;68
021503;gm. Jelcz-Laskowice;oławski;Wrocław;22263;17986;17741;245
021504;gm. Oława;oławski;Wrocław;14958;11912;11762;150
Powiat polkowicki;;;;60592;48557;47881;676
021601;gm. Chocianów;polkowicki;Legnica;12512;10149;9989;160
021602;gm. Gaworzyce;polkowicki;Legnica;3851;3059;2982;77
021603;gm. Grębocice;polkowicki;Legnica;5340;4195;4171;24
021604;gm. Polkowice;polkowicki;Legnica;25962;20710;20396;314
021605;gm. Przemków;polkowicki;Legnica;8127;6656;6627;29
021606;gm. Radwanice;polkowicki;Legnica;4800;3788;3716;72
Powiat strzeliński;;;;42833;35087;34724;363
021701;gm. Borów;strzeliński;Wrocław;5241;4335;4282;53
021702;gm. Kondratowice;strzeliński;Wrocław;4345;3538;3448;90
021703;gm. Przeworno;strzeliński;Wrocław;4775;3919;3879;40
021704;gm. Strzelin;strzeliński;Wrocław;21275;17476;17378;98
021705;gm. Wiązów;strzeliński;Wrocław;7197;5819;5737;82
Powiat średzki;;;;53265;42756;41988;768
021801;gm. Kostomłoty;średzki;Wrocław;7041;5714;5622;92
021802;gm. Malczyce;średzki;Wrocław;5703;4703;4622;81
021803;gm. Miękinia;średzki;Wrocław;16286;12524;12202;322
021804;gm. Środa Śląska;średzki;Wrocław;19097;15567;15385;182
021805;gm. Udanin;średzki;Wrocław;5138;4248;4157;91
Powiat świdnicki;;;;150703;124700;123938;762
021901;m. Świdnica;świdnicki;Wałbrzych;53344;44755;44549;206
021902;m. Świebodzice;świdnicki;Wałbrzych;21476;17814;17731;83
021903;gm. Dobromierz;świdnicki;Wałbrzych;5153;4234;4166;68
021904;gm. Jaworzyna Śląska;świdnicki;Wałbrzych;10148;8306;8235;71
021905;gm. Marcinowice;świdnicki;Wałbrzych;6354;5181;5116;65
021906;gm. Strzegom;świdnicki;Wałbrzych;25059;20821;20778;43
021907;gm. Świdnica;świdnicki;Wałbrzych;16917;13632;13499;133
021908;gm. Żarów;świdnicki;Wałbrzych;12252;9957;9864;93
Powiat trzebnicki;;;;83083;66824;65302;1522
022001;gm. Oborniki Śląskie;trzebnicki;Wrocław;19777;16008;15538;470
022002;gm. Prusice;trzebnicki;Wrocław;9316;7566;7362;204
022003;gm. Trzebnica;trzebnicki;Wrocław;23482;18656;18480;176
022004;gm. Wisznia Mała;trzebnicki;Wrocław;10236;8178;7713;465
022005;gm. Zawonia;trzebnicki;Wrocław;5888;4722;4586;136
022006;gm. Żmigród;trzebnicki;Wrocław;14384;11694;11623;71
Powiat wałbrzyski;;;;53218;44639;44147;492
022101;m. Boguszów-Gorce;wałbrzyski;Wałbrzych;14295;12136;12073;63
022102;m. Jedlina-Zdrój;wałbrzyski;Wałbrzych;4589;3800;3765;35
022103;m. Szczawno-Zdrój;wałbrzyski;Wałbrzych;5340;4552;4478;74
022104;gm. Czarny Bór;wałbrzyski;Wałbrzych;4812;3883;3835;48
022105;gm. Głuszyca;wałbrzyski;Wałbrzych;8296;7016;6956;60
022106;gm. Mieroszów;wałbrzyski;Wałbrzych;6305;5318;5244;74
022107;gm. Stare Bogaczowice;wałbrzyski;Wałbrzych;4167;3408;3354;54
022108;gm. Walim;wałbrzyski;Wałbrzych;5414;4526;4442;84
Powiat wołowski;;;;45470;37484;37098;386
022201;gm. Brzeg Dolny;wołowski;Wrocław;15623;12862;12791;71
022202;gm. Wińsko;wołowski;Wrocław;8315;6852;6670;182
022203;gm. Wołów;wołowski;Wrocław;21532;17770;17637;133
Powiat wrocławski;;;;145187;111697;107363;4334
022301;gm. Czernica;wrocławski;Wrocław;15589;11898;11316;582
022302;gm. Długołęka;wrocławski;Wrocław;32867;25107;23662;1445
022303;gm. Jordanów Śląski;wrocławski;Wrocław;3171;2563;2502;61
022304;gm. Kąty Wrocławskie;wrocławski;Wrocław;23874;18440;17929;511
022305;gm. Kobierzyce;wrocławski;Wrocław;20458;15172;14743;429
022306;gm. Mietków;wrocławski;Wrocław;3832;3072;2961;111
022307;gm. Sobótka;wrocławski;Wrocław;12587;10279;10063;216
022308;gm. Siechnice;wrocławski;Wrocław;21967;16650;16095;555
022309;gm. Żórawina;wrocławski;Wrocław;10842;8516;8092;424
Powiat ząbkowicki;;;;63317;52956;52464;492
022401;gm. Bardo;ząbkowicki;Wałbrzych;5235;4300;4219;81
022402;gm. Ciepłowody;ząbkowicki;Wałbrzych;3086;2505;2454;51
022403;gm. Kamieniec Ząbkowicki;ząbkowicki;Wałbrzych;8034;6684;6604;80
022404;gm. Stoszowice;ząbkowicki;Wałbrzych;5269;4361;4336;25
022405;gm. Ząbkowice Śląskie;ząbkowicki;Wałbrzych;20874;17658;17517;141
022406;gm. Ziębice;ząbkowicki;Wałbrzych;16465;13753;13690;63
022407;gm. Złoty Stok;ząbkowicki;Wałbrzych;4354;3695;3644;51
Powiat zgorzelecki;;;;86179;71654;70923;731
022501;m. Zawidów;zgorzelecki;Jelenia Góra;4037;3339;3317;22
022502;m. Zgorzelec;zgorzelecki;Jelenia Góra;28781;24536;24308;228
022503;gm. Bogatynia;zgorzelecki;Jelenia Góra;22416;18447;18277;170
022504;gm. Pieńsk;zgorzelecki;Jelenia Góra;8648;7069;7010;59
022505;gm. Sulików;zgorzelecki;Jelenia Góra;5944;4801;4731;70
022506;gm. Węgliniec;zgorzelecki;Jelenia Góra;8095;6742;6695;47
022507;gm. Zgorzelec;zgorzelecki;Jelenia Góra;8258;6720;6585;135
Powiat złotoryjski;;;;42372;34914;34693;221
022601;m. Wojcieszów;złotoryjski;Jelenia Góra;3544;2957;2923;34
022602;m. Złotoryja;złotoryjski;Jelenia Góra;14773;12346;12275;71
022603;gm. Pielgrzymka;złotoryjski;Jelenia Góra;4559;3670;3645;25
022604;gm. Świerzawa;złotoryjski;Jelenia Góra;7378;6082;6036;46
022605;gm. Zagrodno;złotoryjski;Jelenia Góra;5189;4298;4280;18
022606;gm. Złotoryja;złotoryjski;Jelenia Góra;6929;5561;5534;27
Miasto na prawach powiatu;;;;;;;
026101;m. Jelenia Góra;Jelenia Góra;Jelenia Góra;72867;61983;61300;683
Miasto na prawach powiatu;;;;;;;
026201;m. Legnica;Legnica;Legnica;91557;75759;75456;303
Miasto na prawach powiatu;;;;;;;
026401;m. Wrocław;Wrocław;Wrocław;584673;478808;471750;7058
Miasto na prawach powiatu;;;;;;;
026501;m. Wałbrzych;Wałbrzych;Wałbrzych;99993;85118;84735;383
Powiat aleksandrowski;;;;53936;44142;43724;418
040101;m. Aleksandrów Kujawski;aleksandrowski;Włocławek;11661;9595;9542;53
040102;m. Ciechocinek;aleksandrowski;Włocławek;9984;8501;8370;131
040103;m. Nieszawa;aleksandrowski;Włocławek;1884;1582;1537;45
040104;gm. Aleksandrów Kujawski;aleksandrowski;Włocławek;11730;9254;9193;61
040105;gm. Bądkowo;aleksandrowski;Włocławek;4301;3491;3475;16
040106;gm. Koneck;aleksandrowski;Włocławek;3205;2641;2638;3
040107;gm. Raciążek;aleksandrowski;Włocławek;3132;2538;2479;59
040108;gm. Waganiec;aleksandrowski;Włocławek;4525;3676;3643;33
040109;gm. Zakrzewo;aleksandrowski;Włocławek;3514;2864;2847;17
Powiat brodnicki;;;;76980;60971;60591;380
040201;m. Brodnica;brodnicki;Toruń;26617;21589;21456;133
040202;gm. Bobrowo;brodnicki;Toruń;6324;5020;4991;29
040203;gm. Brodnica;brodnicki;Toruń;8433;6406;6399;7
040204;gm. Brzozie;brodnicki;Toruń;3858;2939;2922;17
040205;gm. Górzno;brodnicki;Toruń;3938;3138;3090;48
040206;gm. Bartniczka;brodnicki;Toruń;4721;3641;3632;9
040207;gm. Jabłonowo Pomorskie;brodnicki;Toruń;8883;7086;7053;33
040208;gm. Osiek;brodnicki;Toruń;4021;3163;3144;19
040209;gm. Świedziebnia;brodnicki;Toruń;5265;4108;4094;14
040210;gm. Zbiczno;brodnicki;Toruń;4920;3881;3810;71
Powiat bydgoski;;;;113732;89198;88379;819
040301;gm. Białe Błota;bydgoski;Bydgoszcz;21233;16233;16108;125
040302;gm. Dąbrowa Chełmińska;bydgoski;Bydgoszcz;8198;6455;6418;37
040303;gm. Dobrcz;bydgoski;Bydgoszcz;11549;9017;8842;175
040304;gm. Koronowo;bydgoski;Bydgoszcz;23204;18469;18352;117
040305;gm. Nowa Wieś Wielka;bydgoski;Bydgoszcz;9824;7848;7755;93
040306;gm. Osielsko;bydgoski;Bydgoszcz;14071;10725;10599;126
040307;gm. Sicienko;bydgoski;Bydgoszcz;9947;7805;7702;103
040308;gm. Solec Kujawski;bydgoski;Bydgoszcz;15706;12646;12603;43
Powiat chełmiński;;;;49427;39662;39300;362
040401;m. Chełmno;chełmiński;Toruń;17691;14717;14507;210
040402;gm. Chełmno;chełmiński;Toruń;5979;4618;4601;17
040403;gm. Kijewo Królewskie;chełmiński;Toruń;4500;3513;3501;12
040404;gm. Lisewo;chełmiński;Toruń;5072;3987;3940;47
040405;gm. Papowo Biskupie;chełmiński;Toruń;4326;3404;3384;20
040406;gm. Stolno;chełmiński;Toruń;5180;4085;4063;22
040407;gm. Unisław;chełmiński;Toruń;6679;5338;5304;34
Powiat golubsko-dobrzyński;;;;44729;35789;35445;344
040501;m. Golub-Dobrzyń;golubsko-dobrzyński;Toruń;11757;9582;9466;116
040502;gm. Ciechocin;golubsko-dobrzyński;Toruń;4065;3237;3216;21
040503;gm. Golub-Dobrzyń;golubsko-dobrzyński;Toruń;9011;7113;7047;66
040504;gm. Kowalewo Pomorskie;golubsko-dobrzyński;Toruń;11317;9036;8976;60
040505;gm. Radomin;golubsko-dobrzyński;Toruń;4119;3301;3250;51
040506;gm. Zbójno;golubsko-dobrzyński;Toruń;4460;3520;3490;30
Powiat grudziądzki;;;;39900;31235;31051;184
040601;gm. Grudziądz;grudziądzki;Toruń;12464;9661;9607;54
040602;gm. Gruta;grudziądzki;Toruń;6456;5094;5060;34
040603;gm. Łasin;grudziądzki;Toruń;7783;6180;6132;48
040604;gm. Radzyń Chełmiński;grudziądzki;Toruń;4656;3727;3707;20
040605;gm. Rogóźno;grudziądzki;Toruń;4201;3233;3221;12
040606;gm. Świecie nad Osą;grudziądzki;Toruń;4340;3340;3324;16
Powiat inowrocławski;;;;152967;126079;125506;573
040701;m. Inowrocław;inowrocławski;Bydgoszcz;67512;56652;56435;217
040702;gm. Dąbrowa Biskupia;inowrocławski;Bydgoszcz;5059;4020;4013;7
040703;gm. Gniewkowo;inowrocławski;Bydgoszcz;13889;11231;11137;94
040704;gm. Inowrocław;inowrocławski;Bydgoszcz;11725;9482;9441;41
040705;gm. Janikowo;inowrocławski;Bydgoszcz;12887;10600;10577;23
040706;gm. Kruszwica;inowrocławski;Bydgoszcz;18667;15335;15263;72
040707;gm. Pakość;inowrocławski;Bydgoszcz;9635;7800;7770;30
040708;gm. Rojewo;inowrocławski;Bydgoszcz;4614;3679;3639;40
040709;gm. Złotniki Kujawskie;inowrocławski;Bydgoszcz;8979;7280;7231;49
Powiat lipnowski;;;;64964;52053;51495;558
040801;m. Lipno;lipnowski;Włocławek;13478;11107;10995;112
040802;gm. Bobrowniki;lipnowski;Włocławek;3098;2478;2428;50
040803;gm. Chrostkowo;lipnowski;Włocławek;2944;2390;2356;34
040804;gm. Dobrzyń nad Wisłą;lipnowski;Włocławek;7638;6211;6159;52
040805;gm. Kikół;lipnowski;Włocławek;7080;5645;5596;49
040806;gm. Lipno;lipnowski;Włocławek;11740;9252;9177;75
040807;gm. Skępe;lipnowski;Włocławek;7500;6003;5938;65
040808;gm. Tłuchowo;lipnowski;Włocławek;4672;3684;3628;56
040809;gm. Wielgie;lipnowski;Włocławek;6814;5283;5218;65
Powiat mogileński;;;;45131;36643;36496;147
040901;gm. Dąbrowa;mogileński;Bydgoszcz;4595;3679;3667;12
040902;gm. Jeziora Wielkie;mogileński;Bydgoszcz;4830;3854;3837;17
040903;gm. Mogilno;mogileński;Bydgoszcz;24293;19814;19708;106
040904;gm. Strzelno;mogileński;Bydgoszcz;11413;9296;9284;12
Powiat nakielski;;;;83236;66214;65861;353
041001;gm. Kcynia;nakielski;Bydgoszcz;13077;10469;10420;49
041002;gm. Mrocza;nakielski;Bydgoszcz;9017;7061;7035;26
041003;gm. Nakło nad Notecią;nakielski;Bydgoszcz;30086;24212;24091;121
041004;gm. Sadki;nakielski;Bydgoszcz;7182;5628;5615;13
041005;gm. Szubin;nakielski;Bydgoszcz;23874;18844;18700;144
Powiat radziejowski;;;;40556;33442;33184;258
041101;m. Radziejów;radziejowski;Włocławek;5344;4515;4491;24
041102;gm. Bytoń;radziejowski;Włocławek;3570;2919;2872;47
041103;gm. Dobre;radziejowski;Włocławek;5276;4402;4385;17
041104;gm. Osięciny;radziejowski;Włocławek;7714;6352;6303;49
041105;gm. Piotrków Kujawski;radziejowski;Włocławek;9290;7612;7557;55
041106;gm. Radziejów;radziejowski;Włocławek;4439;3591;3581;10
041107;gm. Topólka;radziejowski;Włocławek;4923;4051;3995;56
Powiat rypiński;;;;43126;34705;34494;211
041201;m. Rypin;rypiński;Włocławek;15651;12756;12697;59
041202;gm. Brzuze;rypiński;Włocławek;5310;4244;4201;43
041203;gm. Rogowo;rypiński;Włocławek;4757;3802;3768;34
041204;gm. Rypin;rypiński;Włocławek;7514;5928;5885;43
041205;gm. Skrwilno;rypiński;Włocławek;5886;4731;4720;11
041206;gm. Wąpielsk;rypiński;Włocławek;4008;3244;3223;21
Powiat sępoleński;;;;40460;32036;31808;228
041301;gm. Kamień Krajeński;sępoleński;Bydgoszcz;6967;5423;5377;46
041302;gm. Sępólno Krajeńskie;sępoleński;Bydgoszcz;15491;12399;12321;78
041303;gm. Sośno;sępoleński;Bydgoszcz;4996;3909;3884;25
041304;gm. Więcbork;sępoleński;Bydgoszcz;13006;10305;10226;79
Powiat świecki;;;;94918;75899;75444;455
041401;gm. Bukowiec;świecki;Bydgoszcz;5039;3928;3900;28
041402;gm. Dragacz;świecki;Bydgoszcz;7011;5555;5493;62
041403;gm. Drzycim;świecki;Bydgoszcz;4933;3910;3873;37
041404;gm. Jeżewo;świecki;Bydgoszcz;7921;6204;6182;22
041405;gm. Lniano;świecki;Bydgoszcz;4257;3331;3305;26
041406;gm. Nowe;świecki;Bydgoszcz;9832;7996;7958;38
041407;gm. Osie;świecki;Bydgoszcz;5483;4351;4315;36
041408;gm. Pruszcz;świecki;Bydgoszcz;9327;7409;7330;79
041409;gm. Świecie;świecki;Bydgoszcz;31253;25358;25315;43
041410;gm. Świekatowo;świecki;Bydgoszcz;3566;2871;2839;32
041411;gm. Warlubie;świecki;Bydgoszcz;6296;4986;4934;52
Powiat toruński;;;;105333;81615;80766;849
041501;m. Chełmża;toruński;Toruń;13447;10929;10864;65
041502;gm. Chełmża;toruński;Toruń;9643;7609;7540;69
041503;gm. Czernikowo;toruński;Toruń;9119;7095;6947;148
041504;gm. Lubicz;toruński;Toruń;19542;15165;15063;102
041505;gm. Łubianka;toruński;Toruń;7226;5496;5446;50
041506;gm. Łysomice;toruński;Toruń;10106;7821;7720;101
041507;gm. Obrowo;toruński;Toruń;17206;12927;12736;191
041508;gm. Wielka Nieszawka;toruński;Toruń;5033;3838;3794;44
041509;gm. Zławieś Wielka;toruński;Toruń;14011;10735;10656;79
Powiat tucholski;;;;47510;37637;37351;286
041601;gm. Cekcyn;tucholski;Bydgoszcz;6837;5313;5258;55
041602;gm. Gostycyn;tucholski;Bydgoszcz;5198;4091;4068;23
041603;gm. Kęsowo;tucholski;Bydgoszcz;4510;3528;3516;12
041604;gm. Lubiewo;tucholski;Bydgoszcz;6034;4693;4657;36
041605;gm. Śliwice;tucholski;Bydgoszcz;5546;4381;4337;44
041606;gm. Tuchola;tucholski;Bydgoszcz;19385;15631;15515;116
Powiat wąbrzeski;;;;33302;26824;26666;158
041701;m. Wąbrzeźno;wąbrzeski;Toruń;12546;10358;10251;107
041702;gm. Dębowa Łąka;wąbrzeski;Toruń;3233;2550;2547;3
041703;gm. Książki;wąbrzeski;Toruń;4144;3341;3325;16
041704;gm. Płużnica;wąbrzeski;Toruń;4769;3785;3758;27
041705;gm. Ryńsk;wąbrzeski;Toruń;8610;6790;6785;5
Powiat włocławski;;;;85617;69766;69186;580
041801;m. Kowal;włocławski;Włocławek;3416;2857;2828;29
041802;gm. Baruchowo;włocławski;Włocławek;3466;2808;2785;23
041803;gm. Boniewo;włocławski;Włocławek;3411;2783;2764;19
041804;gm. Brześć Kujawski;włocławski;Włocławek;11114;9133;9069;64
041805;gm. Choceń;włocławski;Włocławek;8064;6541;6456;85
041806;gm. Chodecz;włocławski;Włocławek;5969;4961;4927;34
041807;gm. Fabianki;włocławski;Włocławek;9823;7847;7783;64
041808;gm. Izbica Kujawska;włocławski;Włocławek;7651;6134;6098;36
041809;gm. Kowal;włocławski;Włocławek;3952;3253;3220;33
041810;gm. Lubanie;włocławski;Włocławek;4552;3720;3690;30
041811;gm. Lubień Kujawski;włocławski;Włocławek;7346;6043;5979;64
041812;gm. Lubraniec;włocławski;Włocławek;9535;7827;7794;33
041813;gm. Włocławek;włocławski;Włocławek;7318;5859;5793;66
Powiat żniński;;;;68736;55295;54914;381
041901;gm. Barcin;żniński;Bydgoszcz;14058;11425;11301;124
041902;gm. Gąsawa;żniński;Bydgoszcz;5219;4205;4172;33
041903;gm. Janowiec Wielkopolski;żniński;Bydgoszcz;8924;7121;7078;43
041904;gm. Łabiszyn;żniński;Bydgoszcz;9990;7879;7854;25
041905;gm. Rogowo;żniński;Bydgoszcz;6791;5395;5361;34
041906;gm. Żnin;żniński;Bydgoszcz;23754;19270;19148;122
Miasto na prawach powiatu;;;;;;;
046101;m. Bydgoszcz;Bydgoszcz;Bydgoszcz;314567;261077;259716;1361
Miasto na prawach powiatu;;;;;;;
046201;m. Grudziądz;Grudziądz;Toruń;82783;68368;67840;528
Miasto na prawach powiatu;;;;;;;
046301;m. Toruń;Toruń;Toruń;180884;149340;148325;1015
Miasto na prawach powiatu;;;;;;;
046401;m. Włocławek;Włocławek;Włocławek;102637;86199;85765;434
Powiat bialski;;;;111653;90036;88731;1305
060101;m. Międzyrzec Podlaski;bialski;Biała Podlaska;16525;13493;13390;103
060102;m. Terespol;bialski;Biała Podlaska;5606;4619;4586;33
060103;gm. Biała Podlaska;bialski;Biała Podlaska;14487;11352;11036;316
060104;gm. Drelów;bialski;Biała Podlaska;5468;4330;4311;19
060105;gm. Janów Podlaski;bialski;Biała Podlaska;5265;4231;4170;61
060106;gm. Kodeń;bialski;Biała Podlaska;3620;2995;2900;95
060107;gm. Konstantynów;bialski;Biała Podlaska;4199;3306;3210;96
060108;gm. Leśna Podlaska;bialski;Biała Podlaska;4323;3488;3441;47
060109;gm. Łomazy;bialski;Biała Podlaska;5044;4143;4088;55
060110;gm. Międzyrzec Podlaski;bialski;Biała Podlaska;10425;8219;8165;54
060111;gm. Piszczac;bialski;Biała Podlaska;7289;5870;5795;75
060112;gm. Rokitno;bialski;Biała Podlaska;3027;2437;2392;45
060113;gm. Rossosz;bialski;Biała Podlaska;2284;1876;1853;23
060114;gm. Sławatycze;bialski;Biała Podlaska;2446;1978;1927;51
060115;gm. Sosnówka;bialski;Biała Podlaska;2492;2068;2027;41
060116;gm. Terespol;bialski;Biała Podlaska;6546;5349;5307;42
060117;gm. Tuczna;bialski;Biała Podlaska;3112;2586;2561;25
060118;gm. Wisznice;bialski;Biała Podlaska;5013;4137;4091;46
060119;gm. Zalesie;bialski;Biała Podlaska;4482;3559;3481;78
Powiat biłgorajski;;;;102022;83312;82798;514
060201;m. Biłgoraj;biłgorajski;Zamość;26108;21461;21290;171
060202;gm. Aleksandrów;biłgorajski;Zamość;3325;2627;2618;9
060203;gm. Biłgoraj;biłgorajski;Zamość;13486;10674;10649;25
060204;gm. Biszcza;biłgorajski;Zamość;3906;3149;3121;28
060205;gm. Frampol;biłgorajski;Zamość;6200;5132;5123;9
060206;gm. Goraj;biłgorajski;Zamość;4181;3452;3436;16
060207;gm. Józefów;biłgorajski;Zamość;6888;5802;5754;48
060208;gm. Księżpol;biłgorajski;Zamość;6957;5549;5522;27
060209;gm. Łukowa;biłgorajski;Zamość;4376;3527;3515;12
060210;gm. Obsza;biłgorajski;Zamość;4330;3498;3479;19
060211;gm. Potok Górny;biłgorajski;Zamość;5469;4584;4525;59
060212;gm. Tarnogród;biłgorajski;Zamość;6657;5402;5381;21
060213;gm. Tereszpol;biłgorajski;Zamość;3970;3222;3198;24
060214;gm. Turobin;biłgorajski;Zamość;6169;5233;5187;46
Powiat chełmski;;;;78321;63703;62824;879
060301;m. Rejowiec Fabryczny;chełmski;Chełm;4351;3623;3575;48
060302;gm. Białopole;chełmski;Chełm;2962;2446;2425;21
060303;gm. Chełm;chełmski;Chełm;14798;11709;11577;132
060304;gm. Dorohusk;chełmski;Chełm;6377;5214;5125;89
060305;gm. Dubienka;chełmski;Chełm;2389;2009;1962;47
060306;gm. Kamień;chełmski;Chełm;4219;3356;3313;43
060307;gm. Leśniowice;chełmski;Chełm;3735;3061;2989;72
060308;gm. Rejowiec Fabryczny;chełmski;Chełm;4232;3470;3438;32
060309;gm. Ruda-Huta;chełmski;Chełm;4498;3657;3615;42
060310;gm. Sawin;chełmski;Chełm;5577;4527;4464;63
060311;gm. Siedliszcze;chełmski;Chełm;6764;5474;5422;52
060312;gm. Wierzbica;chełmski;Chełm;5152;4176;4085;91
060313;gm. Wojsławice;chełmski;Chełm;3823;3212;3135;77
060314;gm. Żmudź;chełmski;Chełm;3169;2579;2530;49
060315;gm. Rejowiec;chełmski;Chełm;6275;5190;5169;21
Powiat hrubieszowski;;;;63443;53040;52751;289
060401;m. Hrubieszów;hrubieszowski;Zamość;17232;14472;14417;55
060402;gm. Dołhobyczów;hrubieszowski;Zamość;5499;4594;4571;23
060403;gm. Horodło;hrubieszowski;Zamość;5203;4306;4250;56
060404;gm. Hrubieszów;hrubieszowski;Zamość;10189;8378;8354;24
060405;gm. Mircze;hrubieszowski;Zamość;7020;5980;5946;34
060406;gm. Trzeszczany;hrubieszowski;Zamość;4174;3515;3502;13
060407;gm. Uchanie;hrubieszowski;Zamość;4611;3869;3839;30
060408;gm. Werbkowice;hrubieszowski;Zamość;9515;7926;7872;54
Powiat janowski;;;;45994;37713;37482;231
060501;gm. Batorz;janowski;Lublin;3299;2697;2683;14
060502;gm. Chrzanów;janowski;Lublin;2967;2414;2408;6
060503;gm. Dzwola;janowski;Lublin;6374;5205;5190;15
060504;gm. Godziszów;janowski;Lublin;5832;4775;4767;8
060505;gm. Janów Lubelski;janowski;Lublin;15666;12962;12868;94
060506;gm. Modliborzyce;janowski;Lublin;7088;5780;5727;53
060507;gm. Potok Wielki;janowski;Lublin;4768;3880;3839;41
Powiat krasnostawski;;;;63593;53530;52853;677
060601;m. Krasnystaw;krasnostawski;Chełm;18312;15486;15345;141
060602;gm. Fajsławice;krasnostawski;Chełm;4626;3852;3837;15
060603;gm. Gorzków;krasnostawski;Chełm;3512;2992;2948;44
060604;gm. Izbica;krasnostawski;Chełm;8264;6867;6764;103
060605;gm. Krasnystaw;krasnostawski;Chełm;8598;7100;7065;35
060606;gm. Kraśniczyn;krasnostawski;Chełm;3683;3188;3085;103
060607;gm. Łopiennik Górny;krasnostawski;Chełm;3952;3328;3256;72
060609;gm. Rudnik;krasnostawski;Chełm;3060;2596;2522;74
060610;gm. Siennica Różana;krasnostawski;Chełm;4117;3488;3464;24
060611;gm. Żółkiewka;krasnostawski;Chełm;5469;4633;4567;66
Powiat kraśnicki;;;;94423;77909;77236;673
060701;m. Kraśnik;kraśnicki;Lublin;33040;27953;27679;274
060702;gm. Annopol;kraśnicki;Lublin;8671;7068;6999;69
060703;gm. Dzierzkowice;kraśnicki;Lublin;5330;4323;4319;4
060704;gm. Gościeradów;kraśnicki;Lublin;7233;5862;5814;48
060705;gm. Kraśnik;kraśnicki;Lublin;7255;5874;5858;16
060706;gm. Szastarka;kraśnicki;Lublin;5848;4774;4748;26
060707;gm. Trzydnik Duży;kraśnicki;Lublin;6428;5297;5268;29
060708;gm. Urzędów;kraśnicki;Lublin;8587;7003;6867;136
060709;gm. Wilkołaz;kraśnicki;Lublin;5523;4408;4389;19
060710;gm. Zakrzówek;kraśnicki;Lublin;6508;5347;5295;52
Powiat lubartowski;;;;88247;71460;70797;663
060801;m. Lubartów;lubartowski;Lublin;21352;17506;17410;96
060802;gm. Abramów;lubartowski;Lublin;4119;3373;3354;19
060803;gm. Firlej;lubartowski;Lublin;5909;4772;4729;43
060804;gm. Jeziorzany;lubartowski;Lublin;2802;2270;2247;23
060805;gm. Kamionka;lubartowski;Lublin;6456;5185;5141;44
060806;gm. Kock;lubartowski;Lublin;6429;5228;5193;35
060807;gm. Lubartów;lubartowski;Lublin;11478;9054;8994;60
060808;gm. Michów;lubartowski;Lublin;6041;4989;4878;111
060809;gm. Niedźwiada;lubartowski;Lublin;6318;5049;5021;28
060810;gm. Ostrów Lubelski;lubartowski;Lublin;5296;4332;4272;60
060811;gm. Ostrówek;lubartowski;Lublin;3953;3142;3105;37
060812;gm. Serniki;lubartowski;Lublin;4922;3983;3931;52
060813;gm. Uścimów;lubartowski;Lublin;3172;2577;2522;55
Powiat lubelski;;;;153906;122818;120675;2143
060901;gm. Bełżyce;lubelski;Lublin;13130;10619;10545;74
060902;gm. Borzechów;lubelski;Lublin;3929;3155;3035;120
060903;gm. Bychawa;lubelski;Lublin;11558;9524;9492;32
060904;gm. Garbów;lubelski;Lublin;9055;7261;7181;80
060905;gm. Głusk;lubelski;Lublin;11366;8678;8414;264
060906;gm. Jabłonna;lubelski;Lublin;7987;6419;6315;104
060907;gm. Jastków;lubelski;Lublin;13844;10963;10809;154
060908;gm. Konopnica;lubelski;Lublin;13846;11001;10737;264
060909;gm. Krzczonów;lubelski;Lublin;4414;3852;3673;179
060910;gm. Niedrzwica Duża;lubelski;Lublin;11765;9203;9088;115
060911;gm. Niemce;lubelski;Lublin;19515;15450;15144;306
060912;gm. Strzyżewice;lubelski;Lublin;7913;6326;6248;78
060913;gm. Wojciechów;lubelski;Lublin;5984;4789;4710;79
060914;gm. Wólka;lubelski;Lublin;12086;9258;9105;153
060915;gm. Wysokie;lubelski;Lublin;4551;3852;3765;87
060916;gm. Zakrzew;lubelski;Lublin;2963;2468;2414;54
Powiat łęczyński;;;;56378;44980;44532;448
061001;gm. Cyców;łęczyński;Lublin;7913;6161;6089;72
061002;gm. Ludwin;łęczyński;Lublin;5641;4352;4305;47
061003;gm. Łęczna;łęczyński;Lublin;22509;18245;18164;81
061004;gm. Milejów;łęczyński;Lublin;8936;7259;7210;49
061005;gm. Puchaczów;łęczyński;Lublin;5652;4445;4317;128
061006;gm. Spiczyn;łęczyński;Lublin;5727;4518;4447;71
Powiat łukowski;;;;107000;84453;83752;701
061101;m. Łuków;łukowski;Lublin;28797;23360;23187;173
061102;m. Stoczek Łukowski;łukowski;Lublin;2568;2106;2069;37
061103;gm. Adamów;łukowski;Lublin;5658;4514;4466;48
061104;gm. Krzywda;łukowski;Lublin;10566;8140;8071;69
061105;gm. Łuków;łukowski;Lublin;18211;13789;13730;59
061106;gm. Serokomla;łukowski;Lublin;4077;3263;3202;61
061107;gm. Stanin;łukowski;Lublin;9808;7611;7566;45
061108;gm. Stoczek Łukowski;łukowski;Lublin;7929;6386;6306;80
061109;gm. Trzebieszów;łukowski;Lublin;7558;5900;5870;30
061110;gm. Wojcieszków;łukowski;Lublin;6939;5435;5410;25
061111;gm. Wola Mysłowska;łukowski;Lublin;4889;3949;3875;74
Powiat opolski;;;;59392;48594;48097;497
061201;gm. Chodel;opolski;Lublin;6753;5300;5179;121
061202;gm. Józefów nad Wisłą;opolski;Lublin;6585;5401;5347;54
061203;gm. Karczmiska;opolski;Lublin;5629;4656;4609;47
061204;gm. Łaziska;opolski;Lublin;4943;4018;3985;33
061205;gm. Opole Lubelskie;opolski;Lublin;17041;14007;13924;83
061206;gm. Poniatowa;opolski;Lublin;13906;11490;11416;74
061207;gm. Wilków;opolski;Lublin;4535;3722;3637;85
Powiat parczewski;;;;35129;28748;28479;269
061301;gm. Dębowa Kłoda;parczewski;Biała Podlaska;4075;3316;3251;65
061302;gm. Jabłoń;parczewski;Biała Podlaska;3830;3119;3103;16
061303;gm. Milanów;parczewski;Biała Podlaska;3863;3115;3105;10
061304;gm. Parczew;parczewski;Biała Podlaska;14433;11838;11785;53
061305;gm. Podedwórze;parczewski;Biała Podlaska;1697;1426;1414;12
061306;gm. Siemień;parczewski;Biała Podlaska;4607;3782;3756;26
061307;gm. Sosnowica;parczewski;Biała Podlaska;2624;2152;2065;87
Powiat puławski;;;;112458;93218;92197;1021
061401;m. Puławy;puławski;Lublin;46322;38882;38598;284
061402;gm. Baranów;puławski;Lublin;3969;3280;3216;64
061403;gm. Janowiec;puławski;Lublin;3790;3122;3022;100
061404;gm. Kazimierz Dolny;puławski;Lublin;6704;5612;5525;87
061405;gm. Końskowola;puławski;Lublin;8859;7280;7230;50
061406;gm. Kurów;puławski;Lublin;7650;6261;6223;38
061407;gm. Markuszów;puławski;Lublin;2987;2422;2390;32
061408;gm. Nałęczów;puławski;Lublin;8916;7393;7285;108
061409;gm. Puławy;puławski;Lublin;12072;9864;9783;81
061410;gm. Wąwolnica;puławski;Lublin;4664;3783;3679;104
061411;gm. Żyrzyn;puławski;Lublin;6525;5319;5246;73
Powiat radzyński;;;;59755;48127;47663;464
061501;m. Radzyń Podlaski;radzyński;Biała Podlaska;15276;12554;12419;135
061502;gm. Borki;radzyński;Biała Podlaska;6251;4961;4887;74
061503;gm. Czemierniki;radzyński;Biała Podlaska;4377;3555;3536;19
061504;gm. Kąkolewnica;radzyński;Biała Podlaska;8262;6583;6537;46
061505;gm. Komarówka Podlaska;radzyński;Biała Podlaska;4430;3631;3600;31
061506;gm. Radzyń Podlaski;radzyński;Biała Podlaska;8249;6563;6511;52
061507;gm. Ulan-Majorat;radzyński;Biała Podlaska;6114;4822;4766;56
061508;gm. Wohyń;radzyński;Biała Podlaska;6796;5458;5407;51
Powiat rycki;;;;55647;45530;45118;412
061601;m. Dęblin;rycki;Lublin;15304;12860;12702;158
061602;gm. Kłoczew;rycki;Lublin;7290;5707;5674;33
061603;gm. Nowodwór;rycki;Lublin;4167;3308;3293;15
061604;gm. Ryki;rycki;Lublin;20466;16670;16576;94
061605;gm. Stężyca;rycki;Lublin;5186;4300;4284;16
061606;gm. Ułęż;rycki;Lublin;3234;2685;2589;96
Powiat świdnicki;;;;70345;57700;57324;376
061701;m. Świdnik;świdnicki;Lublin;37841;31294;31186;108
061702;gm. Mełgiew;świdnicki;Lublin;9762;7738;7615;123
061703;gm. Piaski;świdnicki;Lublin;10417;8545;8448;97
061704;gm. Rybczewice;świdnicki;Lublin;3446;2901;2883;18
061705;gm. Trawniki;świdnicki;Lublin;8879;7222;7192;30
Powiat tomaszowski;;;;84427;69860;69287;573
061801;m. Tomaszów Lubelski;tomaszowski;Zamość;18982;15961;15781;180
061802;gm. Bełżec;tomaszowski;Zamość;3391;2710;2691;19
061803;gm. Jarczów;tomaszowski;Zamość;3495;2902;2867;35
061804;gm. Krynice;tomaszowski;Zamość;3299;2745;2722;23
061805;gm. Lubycza Królewska;tomaszowski;Zamość;6293;5170;5132;38
061806;gm. Łaszczów;tomaszowski;Zamość;6055;5091;5055;36
061807;gm. Rachanie;tomaszowski;Zamość;5345;4416;4390;26
061808;gm. Susiec;tomaszowski;Zamość;7639;6267;6229;38
061809;gm. Tarnawatka;tomaszowski;Zamość;3978;3219;3172;47
061810;gm. Telatyn;tomaszowski;Zamość;4003;3334;3315;19
061811;gm. Tomaszów Lubelski;tomaszowski;Zamość;11482;9290;9241;49
061812;gm. Tyszowce;tomaszowski;Zamość;5761;4769;4722;47
061813;gm. Ulhówek;tomaszowski;Zamość;4704;3986;3970;16
Powiat włodawski;;;;38602;31641;31145;496
061901;m. Włodawa;włodawski;Chełm;12807;10583;10485;98
061902;gm. Hanna;włodawski;Chełm;2966;2489;2417;72
061903;gm. Hańsk;włodawski;Chełm;3812;3042;3018;24
061904;gm. Stary Brus;włodawski;Chełm;2180;1779;1694;85
061905;gm. Urszulin;włodawski;Chełm;4279;3409;3357;52
061906;gm. Włodawa;włodawski;Chełm;6048;4893;4839;54
061907;gm. Wola Uhruska;włodawski;Chełm;3867;3274;3230;44
061908;gm. Wyryki;włodawski;Chełm;2643;2172;2105;67
Powiat zamojski;;;;107657;88846;87795;1051
062001;gm. Adamów;zamojski;Zamość;4907;4035;3883;152
062002;gm. Grabowiec;zamojski;Zamość;4119;3475;3435;40
062003;gm. Komarów-Osada;zamojski;Zamość;5101;4249;4137;112
062004;gm. Krasnobród;zamojski;Zamość;7161;5859;5803;56
062005;gm. Łabunie;zamojski;Zamość;6310;5139;5071;68
062006;gm. Miączyn;zamojski;Zamość;5813;4792;4763;29
062007;gm. Nielisz;zamojski;Zamość;5666;4728;4649;79
062008;gm. Radecznica;zamojski;Zamość;5516;4716;4687;29
062009;gm. Sitno;zamojski;Zamość;6761;5485;5467;18
062010;gm. Skierbieszów;zamojski;Zamość;5168;4276;4218;58
062011;gm. Stary Zamość;zamojski;Zamość;5290;4356;4283;73
062012;gm. Sułów;zamojski;Zamość;4538;3794;3755;39
062013;gm. Szczebrzeszyn;zamojski;Zamość;11212;9339;9307;32
062014;gm. Zamość;zamojski;Zamość;23281;18931;18720;211
062015;gm. Zwierzyniec;zamojski;Zamość;6814;5672;5617;55
Miasto na prawach powiatu;;;;;;;
066101;m. Biała Podlaska;Biała Podlaska;Biała Podlaska;55382;45195;44867;328
Miasto na prawach powiatu;;;;;;;
066201;m. Chełm;Chełm;Chełm;59880;50347;50018;329
Miasto na prawach powiatu;;;;;;;
066301;m. Lublin;Lublin;Lublin;318128;260190;258764;1426
Miasto na prawach powiatu;;;;;;;
066401;m. Zamość;Zamość;Zamość;60679;50684;50462;222
Powiat gorzowski;;;;69413;55146;54599;547
080101;m. Kostrzyn nad Odrą;gorzowski;Gorzów Wielkopolski;16711;13345;13307;38
080102;gm. Bogdaniec;gorzowski;Gorzów Wielkopolski;6921;5482;5424;58
080103;gm. Deszczno;gorzowski;Gorzów Wielkopolski;9627;7518;7492;26
080104;gm. Kłodawa;gorzowski;Gorzów Wielkopolski;8405;6690;6507;183
080105;gm. Lubiszyn;gorzowski;Gorzów Wielkopolski;6691;5370;5289;81
080106;gm. Santok;gorzowski;Gorzów Wielkopolski;8630;6773;6661;112
080107;gm. Witnica;gorzowski;Gorzów Wielkopolski;12428;9968;9919;49
Powiat krośnieński;;;;53178;43497;43042;455
080201;m. Gubin;krośnieński;Zielona Góra;15668;12847;12766;81
080202;gm. Bobrowice;krośnieński;Zielona Góra;3157;2595;2512;83
080203;gm. Bytnica;krośnieński;Zielona Góra;2478;1990;1974;16
080204;gm. Dąbie;krośnieński;Zielona Góra;4904;3926;3866;60
080205;gm. Gubin;krośnieński;Zielona Góra;6988;5731;5664;67
080206;gm. Krosno Odrzańskie;krośnieński;Zielona Góra;17185;14142;14064;78
080207;gm. Maszewo;krośnieński;Zielona Góra;2798;2266;2196;70
Powiat międzyrzecki;;;;55806;45457;44960;497
080301;gm. Bledzew;międzyrzecki;Gorzów Wielkopolski;4291;3520;3463;57
080302;gm. Międzyrzecz;międzyrzecki;Gorzów Wielkopolski;23741;19362;19296;66
080303;gm. Przytoczna;międzyrzecki;Gorzów Wielkopolski;5625;4418;4342;76
080304;gm. Pszczew;międzyrzecki;Gorzów Wielkopolski;4157;3362;3277;85
080305;gm. Skwierzyna;międzyrzecki;Gorzów Wielkopolski;11677;9633;9507;126
080306;gm. Trzciel;międzyrzecki;Gorzów Wielkopolski;6315;5162;5075;87
Powiat nowosolski;;;;82375;66962;66480;482
080401;m. Nowa Sól;nowosolski;Zielona Góra;35776;29621;29503;118
080402;gm. Bytom Odrzański;nowosolski;Zielona Góra;5391;4296;4280;16
080403;gm. Kolsko;nowosolski;Zielona Góra;3319;2683;2632;51
080404;gm. Kożuchów;nowosolski;Zielona Góra;15322;12443;12361;82
080405;gm. Nowa Sól;nowosolski;Zielona Góra;6945;5505;5450;55
080406;gm. Nowe Miasteczko;nowosolski;Zielona Góra;5253;4242;4182;60
080407;gm. Otyń;nowosolski;Zielona Góra;6835;5430;5366;64
080408;gm. Siedlisko;nowosolski;Zielona Góra;3534;2742;2706;36
Powiat słubicki;;;;45146;36352;35810;542
080501;gm. Cybinka;słubicki;Gorzów Wielkopolski;6425;5201;5149;52
080502;gm. Górzyca;słubicki;Gorzów Wielkopolski;4214;3325;3302;23
080503;gm. Ośno Lubuskie;słubicki;Gorzów Wielkopolski;6203;5042;4908;134
080504;gm. Rzepin;słubicki;Gorzów Wielkopolski;9534;7629;7507;122
080505;gm. Słubice;słubicki;Gorzów Wielkopolski;18770;15155;14944;211
Powiat strzelecko-drezdenecki;;;;48103;38834;38540;294
080601;gm. Dobiegniew;strzelecko-drezdenecki;Gorzów Wielkopolski;6419;5301;5243;58
080602;gm. Drezdenko;strzelecko-drezdenecki;Gorzów Wielkopolski;16781;13440;13344;96
080603;gm. Stare Kurowo;strzelecko-drezdenecki;Gorzów Wielkopolski;4048;3230;3196;34
080604;gm. Strzelce Krajeńskie;strzelecko-drezdenecki;Gorzów Wielkopolski;16548;13408;13339;69
080605;gm. Zwierzyn;strzelecko-drezdenecki;Gorzów Wielkopolski;4307;3455;3418;37
Powiat sulęciński;;;;34063;27308;26834;474
080701;gm. Krzeszyce;sulęciński;Gorzów Wielkopolski;4704;3726;3597;129
080702;gm. Lubniewice;sulęciński;Gorzów Wielkopolski;3088;2571;2496;75
080703;gm. Słońsk;sulęciński;Gorzów Wielkopolski;4691;3727;3680;47
080704;gm. Sulęcin;sulęciński;Gorzów Wielkopolski;14984;12034;11881;153
080705;gm. Torzym;sulęciński;Gorzów Wielkopolski;6596;5250;5180;70
Powiat świebodziński;;;;53912;43767;43266;501
080801;gm. Lubrza;świebodziński;Zielona Góra;3543;2833;2762;71
080802;gm. Łagów;świebodziński;Zielona Góra;4934;4084;4005;79
080803;gm. Skąpe;świebodziński;Zielona Góra;4974;4000;3870;130
080804;gm. Szczaniec;świebodziński;Zielona Góra;3796;3087;3020;67
080805;gm. Świebodzin;świebodziński;Zielona Góra;28554;23245;23123;122
080806;gm. Zbąszynek;świebodziński;Zielona Góra;8111;6518;6486;32
Powiat zielonogórski;;;;72302;58691;58060;631
080901;gm. Babimost;zielonogórski;Zielona Góra;6050;4944;4913;31
080902;gm. Bojadła;zielonogórski;Zielona Góra;3265;2642;2555;87
080903;gm. Czerwieńsk;zielonogórski;Zielona Góra;9609;7732;7658;74
080904;gm. Kargowa;zielonogórski;Zielona Góra;5774;4645;4585;60
080905;gm. Nowogród Bobrzański;zielonogórski;Zielona Góra;9040;7368;7331;37
080906;gm. Sulechów;zielonogórski;Zielona Góra;24629;20197;20063;134
080907;gm. Świdnica;zielonogórski;Zielona Góra;6475;5260;5149;111
080908;gm. Trzebiechów;zielonogórski;Zielona Góra;3278;2581;2562;19
080909;gm. Zabór;zielonogórski;Zielona Góra;4182;3322;3244;78
Powiat żagański;;;;76173;62458;61998;460
081001;m. Gozdnica;żagański;Zielona Góra;2973;2505;2494;11
081002;m. Żagań;żagański;Zielona Góra;24079;19905;19786;119
081003;gm. Brzeźnica;żagański;Zielona Góra;3718;2926;2910;16
081004;gm. Iłowa;żagański;Zielona Góra;6592;5450;5401;49
081005;gm. Małomice;żagański;Zielona Góra;5135;4206;4164;42
081006;gm. Niegosławice;żagański;Zielona Góra;4402;3507;3467;40
081007;gm. Szprotawa;żagański;Zielona Góra;19879;16374;16296;78
081008;gm. Wymiarki;żagański;Zielona Góra;2241;1849;1832;17
081009;gm. Żagań;żagański;Zielona Góra;7154;5736;5648;88
Powiat żarski;;;;93011;76011;75521;490
081101;m. Łęknica;żarski;Zielona Góra;2438;1946;1907;39
081102;m. Żary;żarski;Zielona Góra;35588;29224;29156;68
081103;gm. Brody;żarski;Zielona Góra;3295;2667;2629;38
081104;gm. Jasień;żarski;Zielona Góra;6808;5592;5545;47
081105;gm. Lipinki Łużyckie;żarski;Zielona Góra;3251;2591;2542;49
081106;gm. Lubsko;żarski;Zielona Góra;17926;14793;14730;63
081107;gm. Przewóz;żarski;Zielona Góra;3106;2530;2508;22
081108;gm. Trzebiel;żarski;Zielona Góra;5586;4557;4515;42
081109;gm. Tuplice;żarski;Zielona Góra;2983;2466;2426;40
081110;gm. Żary;żarski;Zielona Góra;12030;9645;9563;82
Powiat wschowski;;;;38101;30475;30119;356
081201;gm. Sława;wschowski;Zielona Góra;12500;9912;9732;180
081202;gm. Szlichtyngowa;wschowski;Zielona Góra;5001;3995;3940;55
081203;gm. Wschowa;wschowski;Zielona Góra;20600;16568;16447;121
Miasto na prawach powiatu;;;;;;;
086101;m. Gorzów Wielkopolski;Gorzów Wielkopolski;Gorzów Wielkopolski;114136;93457;92887;570
Miasto na prawach powiatu;;;;;;;
086201;m. Zielona Góra;Zielona Góra;Zielona Góra;130672;106368;105782;586
Powiat bełchatowski;;;;111828;90431;89266;1165
100101;m. Bełchatów;bełchatowski;Piotrków Trybunalski;56143;45921;45669;252
100102;gm. Bełchatów;bełchatowski;Piotrków Trybunalski;11501;9188;9035;153
100103;gm. Drużbice;bełchatowski;Piotrków Trybunalski;5314;4320;4119;201
100104;gm. Kleszczów;bełchatowski;Piotrków Trybunalski;6322;4611;4552;59
100105;gm. Kluki;bełchatowski;Piotrków Trybunalski;4403;3561;3447;114
100106;gm. Rusiec;bełchatowski;Piotrków Trybunalski;5165;4228;4047;181
100107;gm. Szczerców;bełchatowski;Piotrków Trybunalski;8189;6640;6505;135
100108;gm. Zelów;bełchatowski;Piotrków Trybunalski;14791;11962;11892;70
Powiat kutnowski;;;;95365;79878;79226;652
100201;m. Kutno;kutnowski;Łódź;43053;36349;36116;233
100202;gm. Bedlno;kutnowski;Łódź;5472;4572;4498;74
100203;gm. Dąbrowice;kutnowski;Łódź;1937;1624;1576;48
100204;gm. Krośniewice;kutnowski;Łódź;8202;6837;6796;41
100205;gm. Krzyżanów;kutnowski;Łódź;4204;3461;3439;22
100206;gm. Kutno;kutnowski;Łódź;8611;7077;7048;29
100207;gm. Łanięta;kutnowski;Łódź;2409;1924;1889;35
100208;gm. Nowe Ostrowy;kutnowski;Łódź;3453;2892;2867;25
100209;gm. Oporów;kutnowski;Łódź;2534;2066;1998;68
100210;gm. Strzelce;kutnowski;Łódź;3878;3235;3178;57
100211;gm. Żychlin;kutnowski;Łódź;11612;9841;9821;20
Powiat łaski;;;;49396;40615;40177;438
100301;gm. Buczek;łaski;Łódź;5060;4053;4021;32
100302;gm. Łask;łaski;Łódź;27068;22309;22156;153
100303;gm. Sędziejowice;łaski;Łódź;6414;5224;5153;71
100304;gm. Widawa;łaski;Łódź;7411;6230;6107;123
100305;gm. Wodzierady;łaski;Łódź;3443;2799;2740;59
Powiat łęczycki;;;;49629;41123;40714;409
100401;m. Łęczyca;łęczycki;Łódź;13690;11429;11267;162
100402;gm. Daszyna;łęczycki;Łódź;3974;3259;3210;49
100403;gm. Góra Świętej Małgorzaty;łęczycki;Łódź;4399;3586;3561;25
100404;gm. Grabów;łęczycki;Łódź;5959;4961;4909;52
100405;gm. Łęczyca;łęczycki;Łódź;8522;6997;6950;47
100406;gm. Piątek;łęczycki;Łódź;5978;4919;4886;33
100407;gm. Świnice Warckie;łęczycki;Łódź;3879;3249;3229;20
100408;gm. Witonia;łęczycki;Łódź;3228;2723;2702;21
Powiat łowicki;;;;77688;63651;63246;405
100501;m. Łowicz;łowicki;Łódź;27726;22832;22710;122
100502;gm. Bielawy;łowicki;Łódź;5395;4508;4403;105
100503;gm. Chąśno;łowicki;Łódź;2949;2444;2439;5
100504;gm. Domaniewice;łowicki;Łódź;4624;3707;3687;20
100505;gm. Kiernozia;łowicki;Łódź;3383;2812;2790;22
100506;gm. Kocierzew Południowy;łowicki;Łódź;4271;3480;3470;10
100507;gm. Łowicz;łowicki;Łódź;7708;6227;6206;21
100508;gm. Łyszkowice;łowicki;Łódź;6631;5357;5326;31
100509;gm. Nieborów;łowicki;Łódź;9374;7594;7548;46
100510;gm. Zduny;łowicki;Łódź;5627;4690;4667;23
Powiat łódzki wschodni;;;;70337;56710;55784;926
100602;gm. Andrespol;łódzki wschodni;Łódź;13787;11031;10853;178
100603;gm. Brójce;łódzki wschodni;Łódź;6625;5206;5093;113
100607;gm. Koluszki;łódzki wschodni;Łódź;22788;18683;18490;193
100608;gm. Nowosolna;łódzki wschodni;Łódź;5003;3965;3755;210
100610;gm. Rzgów;łódzki wschodni;Łódź;10039;7992;7931;61
100611;gm. Tuszyn;łódzki wschodni;Łódź;12095;9833;9662;171
Powiat opoczyński;;;;76610;61843;61196;647
100701;gm. Białaczów;opoczyński;Skierniewice;5849;4757;4661;96
100702;gm. Drzewica;opoczyński;Skierniewice;10522;8606;8568;38
100703;gm. Mniszków;opoczyński;Skierniewice;4788;3819;3723;96
100704;gm. Opoczno;opoczyński;Skierniewice;33880;27435;27302;133
100705;gm. Paradyż;opoczyński;Skierniewice;4469;3513;3472;41
100706;gm. Poświętne;opoczyński;Skierniewice;3244;2671;2615;56
100707;gm. Sławno;opoczyński;Skierniewice;7819;6045;6005;40
100708;gm. Żarnów;opoczyński;Skierniewice;6039;4997;4850;147
Powiat pabianicki;;;;113827;94183;93194;989
100801;m. Konstantynów Łódzki;pabianicki;Łódź;17712;14558;14280;278
100802;m. Pabianice;pabianicki;Łódź;60773;51276;51099;177
100803;gm. Dłutów;pabianicki;Łódź;4652;3743;3657;86
100804;gm. Dobroń;pabianicki;Łódź;7575;6125;6037;88
100805;gm. Ksawerów;pabianicki;Łódź;7529;6094;6001;93
100806;gm. Lutomiersk;pabianicki;Łódź;8301;6677;6528;149
100807;gm. Pabianice;pabianicki;Łódź;7285;5710;5592;118
Powiat pajęczański;;;;51501;42320;41720;600
100901;gm. Działoszyn;pajęczański;Sieradz;12363;10155;10046;109
100902;gm. Kiełczygłów;pajęczański;Sieradz;4091;3406;3340;66
100903;gm. Nowa Brzeźnica;pajęczański;Sieradz;4551;3825;3782;43
100904;gm. Pajęczno;pajęczański;Sieradz;11640;9513;9417;96
100905;gm. Rząśnia;pajęczański;Sieradz;4974;4005;3872;133
100906;gm. Siemkowice;pajęczański;Sieradz;4886;3953;3909;44
100907;gm. Strzelce Wielkie;pajęczański;Sieradz;4543;3780;3753;27
100908;gm. Sulmierzyce;pajęczański;Sieradz;4453;3683;3601;82
Powiat piotrkowski;;;;91203;73102;72021;1081
101001;gm. Aleksandrów;piotrkowski;Piotrków Trybunalski;4558;3744;3547;197
101002;gm. Czarnocin;piotrkowski;Piotrków Trybunalski;4062;3287;3236;51
101003;gm. Gorzkowice;piotrkowski;Piotrków Trybunalski;8566;6907;6755;152
101004;gm. Grabica;piotrkowski;Piotrków Trybunalski;6077;4793;4784;9
101005;gm. Łęki Szlacheckie;piotrkowski;Piotrków Trybunalski;3536;2904;2804;100
101006;gm. Moszczenica;piotrkowski;Piotrków Trybunalski;12740;10182;10155;27
101007;gm. Ręczno;piotrkowski;Piotrków Trybunalski;3654;2973;2885;88
101008;gm. Rozprza;piotrkowski;Piotrków Trybunalski;12207;9608;9534;74
101009;gm. Sulejów;piotrkowski;Piotrków Trybunalski;16206;13064;12831;233
101010;gm. Wola Krzysztoporska;piotrkowski;Piotrków Trybunalski;11820;9403;9360;43
101011;gm. Wolbórz;piotrkowski;Piotrków Trybunalski;7777;6237;6130;107
Powiat poddębicki;;;;40881;33692;33161;531
101101;gm. Dalików;poddębicki;Łódź;3913;3170;3097;73
101102;gm. Pęczniew;poddębicki;Łódź;3537;2892;2826;66
101103;gm. Poddębice;poddębicki;Łódź;15185;12530;12334;196
101104;gm. Uniejów;poddębicki;Łódź;6954;5821;5768;53
101105;gm. Wartkowice;poddębicki;Łódź;6244;5097;5054;43
101106;gm. Zadzim;poddębicki;Łódź;5048;4182;4082;100
Powiat radomszczański;;;;111388;92230;91040;1190
101201;m. Radomsko;radomszczański;Piotrków Trybunalski;44393;37343;37074;269
101202;gm. Dobryszyce;radomszczański;Piotrków Trybunalski;4370;3502;3461;41
101203;gm. Gidle;radomszczański;Piotrków Trybunalski;6079;5113;5056;57
101204;gm. Gomunice;radomszczański;Piotrków Trybunalski;5863;4785;4676;109
101205;gm. Kamieńsk;radomszczański;Piotrków Trybunalski;5855;4793;4701;92
101206;gm. Kobiele Wielkie;radomszczański;Piotrków Trybunalski;4449;3576;3535;41
101207;gm. Kodrąb;radomszczański;Piotrków Trybunalski;4603;3774;3704;70
101208;gm. Lgota Wielka;radomszczański;Piotrków Trybunalski;4257;3485;3460;25
101209;gm. Ładzice;radomszczański;Piotrków Trybunalski;4802;3882;3837;45
101210;gm. Masłowice;radomszczański;Piotrków Trybunalski;4255;3438;3331;107
101211;gm. Przedbórz;radomszczański;Piotrków Trybunalski;7197;5967;5833;134
101212;gm. Radomsko;radomszczański;Piotrków Trybunalski;5506;4479;4450;29
101213;gm. Wielgomłyny;radomszczański;Piotrków Trybunalski;4604;3779;3657;122
101214;gm. Żytno;radomszczański;Piotrków Trybunalski;5155;4314;4265;49
Powiat rawski;;;;48191;39134;38862;272
101301;m. Rawa Mazowiecka;rawski;Skierniewice;16928;13813;13701;112
101302;gm. Biała Rawska;rawski;Skierniewice;11262;9145;9098;47
101303;gm. Cielądz;rawski;Skierniewice;3976;3222;3191;31
101304;gm. Rawa Mazowiecka;rawski;Skierniewice;8672;6984;6966;18
101305;gm. Regnów;rawski;Skierniewice;1843;1502;1463;39
101306;gm. Sadkowice;rawski;Skierniewice;5510;4468;4443;25
Powiat sieradzki;;;;116080;94706;93906;800
101401;m. Sieradz;sieradzki;Sieradz;40433;33493;33294;199
101402;gm. Błaszki;sieradzki;Sieradz;14520;11814;11698;116
101403;gm. Brąszewice;sieradzki;Sieradz;4496;3540;3495;45
101404;gm. Brzeźnio;sieradzki;Sieradz;6274;5101;5072;29
101405;gm. Burzenin;sieradzki;Sieradz;5483;4477;4453;24
101406;gm. Goszczanów;sieradzki;Sieradz;5471;4422;4379;43
101407;gm. Klonowa;sieradzki;Sieradz;2902;2337;2320;17
101408;gm. Sieradz;sieradzki;Sieradz;10558;8416;8343;73
101409;gm. Warta;sieradzki;Sieradz;12627;10295;10144;151
101410;gm. Wróblew;sieradzki;Sieradz;6072;4948;4919;29
101411;gm. Złoczew;sieradzki;Sieradz;7244;5863;5789;74
Powiat skierniewicki;;;;38120;30616;30156;460
101501;gm. Bolimów;skierniewicki;Skierniewice;3928;3178;3137;41
101502;gm. Głuchów;skierniewicki;Skierniewice;5808;4662;4604;58
101503;gm. Godzianów;skierniewicki;Skierniewice;2644;2109;2093;16
101504;gm. Kowiesy;skierniewicki;Skierniewice;2973;2421;2305;116
101505;gm. Lipce Reymontowskie;skierniewicki;Skierniewice;3278;2643;2609;34
101506;gm. Maków;skierniewicki;Skierniewice;6067;4848;4781;67
101507;gm. Nowy Kawęczyn;skierniewicki;Skierniewice;3423;2805;2726;79
101508;gm. Skierniewice;skierniewicki;Skierniewice;7415;5894;5856;38
101509;gm. Słupia;skierniewicki;Skierniewice;2584;2056;2045;11
Powiat tomaszowski;;;;113506;92724;91837;887
101601;m. Tomaszów Mazowiecki;tomaszowski;Skierniewice;58878;48836;48588;248
101602;gm. Będków;tomaszowski;Skierniewice;3296;2731;2715;16
101603;gm. Budziszewice;tomaszowski;Skierniewice;2175;1720;1668;52
101604;gm. Czerniewice;tomaszowski;Skierniewice;5127;4104;4058;46
101605;gm. Inowłódz;tomaszowski;Skierniewice;3806;3199;3141;58
101606;gm. Lubochnia;tomaszowski;Skierniewice;7129;5612;5477;135
101607;gm. Rokiciny;tomaszowski;Skierniewice;6119;4934;4844;90
101608;gm. Rzeczyca;tomaszowski;Skierniewice;4740;3888;3812;76
101609;gm. Tomaszów Mazowiecki;tomaszowski;Skierniewice;11145;8797;8715;82
101610;gm. Ujazd;tomaszowski;Skierniewice;7727;6217;6195;22
101611;gm. Żelechlinek;tomaszowski;Skierniewice;3364;2686;2624;62
Powiat wieluński;;;;76074;62220;61688;532
101701;gm. Biała;wieluński;Sieradz;5505;4460;4431;29
101702;gm. Czarnożyły;wieluński;Sieradz;4477;3663;3650;13
101703;gm. Konopnica;wieluński;Sieradz;3823;3168;3071;97
101704;gm. Mokrsko;wieluński;Sieradz;5392;4359;4327;32
101705;gm. Osjaków;wieluński;Sieradz;4790;3817;3748;69
101706;gm. Ostrówek;wieluński;Sieradz;4553;3649;3588;61
101707;gm. Pątnów;wieluński;Sieradz;6563;5266;5171;95
101708;gm. Skomlin;wieluński;Sieradz;3290;2627;2608;19
101709;gm. Wieluń;wieluński;Sieradz;31037;25777;25687;90
101710;gm. Wierzchlas;wieluński;Sieradz;6644;5434;5407;27
Powiat wieruszowski;;;;42113;34024;33793;231
101801;gm. Bolesławiec;wieruszowski;Sieradz;4119;3323;3298;25
101802;gm. Czastary;wieruszowski;Sieradz;3968;3188;3165;23
101803;gm. Galewice;wieruszowski;Sieradz;6177;4983;4937;46
101804;gm. Lututów;wieruszowski;Sieradz;4583;3668;3636;32
101805;gm. Łubnice;wieruszowski;Sieradz;4111;3355;3350;5
101806;gm. Sokolniki;wieruszowski;Sieradz;4993;4039;4020;19
101807;gm. Wieruszów;wieruszowski;Sieradz;14162;11468;11387;81
Powiat zduńskowolski;;;;64593;52744;52401;343
101901;m. Zduńska Wola;zduńskowolski;Sieradz;40083;33056;32900;156
101902;gm. Szadek;zduńskowolski;Sieradz;7284;5928;5871;57
101903;gm. Zapolice;zduńskowolski;Sieradz;5206;4192;4117;75
101904;gm. Zduńska Wola;zduńskowolski;Sieradz;12020;9568;9513;55
Powiat zgierski;;;;160034;131240;129332;1908
102001;m. Głowno;zgierski;Łódź;13807;11542;11452;90
102002;m. Ozorków;zgierski;Łódź;18375;15293;15231;62
102003;m. Zgierz;zgierski;Łódź;53111;44124;43877;247
102004;gm. Aleksandrów Łódzki;zgierski;Łódź;31028;24717;24373;344
102005;gm. Głowno;zgierski;Łódź;4758;3918;3893;25
102006;gm. Ozorków;zgierski;Łódź;7018;5719;5581;138
102007;gm. Parzęczew;zgierski;Łódź;5157;4148;3915;233
102008;gm. Stryków;zgierski;Łódź;12583;10216;9984;232
102009;gm. Zgierz;zgierski;Łódź;14197;11563;11026;537
Powiat brzeziński;;;;30162;24589;24330;259
102101;m. Brzeziny;brzeziński;Łódź;12071;9850;9796;54
102102;gm. Brzeziny;brzeziński;Łódź;5629;4536;4449;87
102103;gm. Dmosin;brzeziński;Łódź;4428;3693;3624;69
102104;gm. Jeżów;brzeziński;Łódź;3371;2749;2722;27
102105;gm. Rogów;brzeziński;Łódź;4663;3761;3739;22
Miasto na prawach powiatu;;;;;;;
106101;m. Łódź;Łódź;Łódź;626194;528349;524203;4146
Miasto na prawach powiatu;;;;;;;
106201;m. Piotrków Trybunalski;Piotrków Trybunalski;Piotrków Trybunalski;69938;57669;57165;504
Miasto na prawach powiatu;;;;;;;
106301;m. Skierniewice;Skierniewice;Skierniewice;46084;37387;37079;308
Powiat bocheński;;;;105864;83184;82343;841
120101;m. Bochnia;bocheński;Tarnów;28928;23244;23031;213
120102;gm. Bochnia;bocheński;Tarnów;19985;15739;15610;129
120103;gm. Drwinia;bocheński;Tarnów;6543;5265;5195;70
120104;gm. Lipnica Murowana;bocheński;Tarnów;5652;4411;4340;71
120105;gm. Łapanów;bocheński;Tarnów;8227;6389;6296;93
120106;gm. Nowy Wiśnicz;bocheński;Tarnów;14015;10713;10635;78
120107;gm. Rzezawa;bocheński;Tarnów;11282;8898;8832;66
120108;gm. Trzciana;bocheński;Tarnów;5688;4335;4248;87
120109;gm. Żegocina;bocheński;Tarnów;5544;4190;4156;34
Powiat brzeski;;;;93092;74051;73606;445
120201;gm. Borzęcin;brzeski;Tarnów;8367;6810;6776;34
120202;gm. Brzesko;brzeski;Tarnów;36011;28992;28870;122
120203;gm. Czchów;brzeski;Tarnów;9935;7669;7589;80
120204;gm. Dębno;brzeski;Tarnów;14671;11666;11573;93
120205;gm. Gnojnik;brzeski;Tarnów;8019;6155;6092;63
120206;gm. Iwkowa;brzeski;Tarnów;6600;5003;4977;26
120207;gm. Szczurowa;brzeski;Tarnów;9489;7756;7729;27
Powiat chrzanowski;;;;119790;99514;98714;800
120301;gm. Alwernia;chrzanowski;Kraków;12445;10225;10120;105
120302;gm. Babice;chrzanowski;Kraków;9005;7440;7386;54
120303;gm. Chrzanów;chrzanowski;Kraków;43958;36960;36659;301
120304;gm. Libiąż;chrzanowski;Kraków;21822;17916;17818;98
120305;gm. Trzebinia;chrzanowski;Kraków;32560;26973;26731;242
Powiat dąbrowski;;;;58795;47938;47624;314
120401;gm. Bolesław;dąbrowski;Tarnów;2656;2290;2269;21
120402;gm. Dąbrowa Tarnowska;dąbrowski;Tarnów;20866;16887;16785;102
120403;gm. Gręboszów;dąbrowski;Tarnów;3333;2861;2825;36
120404;gm. Mędrzechów;dąbrowski;Tarnów;3444;2840;2796;44
120405;gm. Olesno;dąbrowski;Tarnów;7902;6425;6412;13
120406;gm. Radgoszcz;dąbrowski;Tarnów;7507;5945;5920;25
120407;gm. Szczucin;dąbrowski;Tarnów;13087;10690;10617;73
Powiat gorlicki;;;;109358;87236;86706;530
120501;m. Gorlice;gorlicki;Nowy Sącz;26985;22334;22169;165
120502;gm. Biecz;gorlicki;Nowy Sącz;17010;13690;13663;27
120503;gm. Bobowa;gorlicki;Nowy Sącz;9871;7473;7446;27
120504;gm. Gorlice;gorlicki;Nowy Sącz;17325;13952;13921;31
120505;gm. Lipinki;gorlicki;Nowy Sącz;6875;5543;5518;25
120506;gm. Łużna;gorlicki;Nowy Sącz;8627;6706;6682;24
120507;gm. Moszczenica;gorlicki;Nowy Sącz;5066;3924;3874;50
120508;gm. Ropa;gorlicki;Nowy Sącz;5535;4182;4141;41
120509;gm. Sękowa;gorlicki;Nowy Sącz;5101;4072;4034;38
120510;gm. Uście Gorlickie;gorlicki;Nowy Sącz;6963;5360;5258;102
Powiat krakowski;;;;273744;217725;213234;4491
120601;gm. Czernichów;krakowski;Kraków;14370;11511;11302;209
120602;gm. Igołomia-Wawrzeńczyce;krakowski;Kraków;7715;6239;6128;111
120603;gm. Iwanowice;krakowski;Kraków;9117;7226;7071;155
120604;gm. Jerzmanowice-Przeginia;krakowski;Kraków;11010;8894;8763;131
120605;gm. Kocmyrzów-Luborzyca;krakowski;Kraków;15359;12264;12044;220
120606;gm. Krzeszowice;krakowski;Kraków;31602;25773;25504;269
120607;gm. Liszki;krakowski;Kraków;17025;13409;13139;270
120608;gm. Michałowice;krakowski;Kraków;10441;8126;7883;243
120609;gm. Mogilany;krakowski;Kraków;13975;10894;10528;366
120610;gm. Skała;krakowski;Kraków;10568;8377;8173;204
120611;gm. Skawina;krakowski;Kraków;42256;33971;33735;236
120612;gm. Słomniki;krakowski;Kraków;13548;10954;10812;142
120613;gm. Sułoszowa;krakowski;Kraków;5846;4647;4599;48
120614;gm. Świątniki Górne;krakowski;Kraków;10116;8025;7841;184
120615;gm. Wielka Wieś;krakowski;Kraków;12501;9704;9270;434
120616;gm. Zabierzów;krakowski;Kraków;26232;20968;20181;787
120617;gm. Zielonki;krakowski;Kraków;22063;16743;16261;482
Powiat limanowski;;;;132133;100513;99818;695
120701;m. Limanowa;limanowski;Nowy Sącz;14852;11760;11694;66
120702;m. Mszana Dolna;limanowski;Nowy Sącz;7892;6251;6141;110
120703;gm. Dobra;limanowski;Nowy Sącz;10077;7801;7726;75
120704;gm. Jodłownik;limanowski;Nowy Sącz;8738;6626;6573;53
120705;gm. Kamienica;limanowski;Nowy Sącz;7971;6042;5987;55
120706;gm. Laskowa;limanowski;Nowy Sącz;8207;6148;6100;48
120707;gm. Limanowa;limanowski;Nowy Sącz;25781;19371;19310;61
120708;gm. Łukowica;limanowski;Nowy Sącz;10155;7541;7497;44
120709;gm. Mszana Dolna;limanowski;Nowy Sącz;17697;13400;13307;93
120710;gm. Niedźwiedź;limanowski;Nowy Sącz;7402;5552;5514;38
120711;gm. Słopnice;limanowski;Nowy Sącz;6782;4963;4947;16
120712;gm. Tymbark;limanowski;Nowy Sącz;6579;5058;5022;36
Powiat miechowski;;;;48611;40033;39387;646
120801;gm. Charsznica;miechowski;Kraków;7396;6163;6110;53
120802;gm. Gołcza;miechowski;Kraków;6046;5016;4934;82
120803;gm. Kozłów;miechowski;Kraków;4633;3860;3754;106
120804;gm. Książ Wielki;miechowski;Kraków;5235;4231;4160;71
120805;gm. Miechów;miechowski;Kraków;19152;15742;15549;193
120806;gm. Racławice;miechowski;Kraków;2572;2091;2012;79
120807;gm. Słaboszów;miechowski;Kraków;3577;2930;2868;62
Powiat myślenicki;;;;126860;98635;97735;900
120901;gm. Dobczyce;myślenicki;Kraków;15127;11842;11618;224
120902;gm. Lubień;myślenicki;Kraków;10100;7757;7704;53
120903;gm. Myślenice;myślenicki;Kraków;43760;34371;34176;195
120904;gm. Pcim;myślenicki;Kraków;11156;8646;8546;100
120905;gm. Raciechowice;myślenicki;Kraków;6517;5120;5040;80
120906;gm. Siepraw;myślenicki;Kraków;8988;6886;6795;91
120907;gm. Sułkowice;myślenicki;Kraków;14885;11552;11502;50
120908;gm. Tokarnia;myślenicki;Kraków;8864;6755;6726;29
120909;gm. Wiśniowa;myślenicki;Kraków;7463;5706;5628;78
Powiat nowosądecki;;;;217557;166582;165612;970
121001;m. Grybów;nowosądecki;Nowy Sącz;6085;4849;4806;43
121002;gm. Chełmiec;nowosądecki;Nowy Sącz;28843;22033;21855;178
121003;gm. Gródek nad Dunajcem;nowosądecki;Nowy Sącz;9403;7163;7104;59
121004;gm. Grybów;nowosądecki;Nowy Sącz;25637;19064;18997;67
121005;gm. Kamionka Wielka;nowosądecki;Nowy Sącz;10559;7886;7863;23
121006;gm. Korzenna;nowosądecki;Nowy Sącz;14663;11162;11132;30
121007;gm. Krynica-Zdrój;nowosądecki;Nowy Sącz;16726;13524;13336;188
121008;gm. Łabowa;nowosądecki;Nowy Sącz;6096;4490;4470;20
121009;gm. Łącko;nowosądecki;Nowy Sącz;16668;12464;12409;55
121010;gm. Łososina Dolna;nowosądecki;Nowy Sącz;11112;8295;8252;43
121011;gm. Muszyna;nowosądecki;Nowy Sącz;11655;9207;9136;71
121012;gm. Nawojowa;nowosądecki;Nowy Sącz;8636;6507;6485;22
121013;gm. Piwniczna-Zdrój;nowosądecki;Nowy Sącz;10654;8436;8387;49
121014;gm. Podegrodzie;nowosądecki;Nowy Sącz;13323;9926;9888;38
121015;gm. Rytro;nowosądecki;Nowy Sącz;3794;2964;2952;12
121016;gm. Stary Sącz;nowosądecki;Nowy Sącz;23703;18612;18540;72
Powiat nowotarski;;;;190485;150630;149507;1123
121101;m. Nowy Targ;nowotarski;Nowy Sącz;32046;26137;25923;214
121102;gm. Szczawnica;nowotarski;Nowy Sącz;7251;5851;5762;89
121103;gm. Czarny Dunajec;nowotarski;Nowy Sącz;22404;17901;17786;115
121104;gm. Czorsztyn;nowotarski;Nowy Sącz;7652;5989;5941;48
121105;gm. Jabłonka;nowotarski;Nowy Sącz;19033;14453;14427;26
121106;gm. Krościenko nad Dunajcem;nowotarski;Nowy Sącz;6894;5365;5230;135
121107;gm. Lipnica Wielka;nowotarski;Nowy Sącz;6129;4597;4551;46
121108;gm. Łapsze Niżne;nowotarski;Nowy Sącz;9272;7397;7356;41
121109;gm. Nowy Targ;nowotarski;Nowy Sącz;23951;18864;18811;53
121110;gm. Ochotnica Dolna;nowotarski;Nowy Sącz;8613;6593;6559;34
121111;gm. Raba Wyżna;nowotarski;Nowy Sącz;14711;11479;11402;77
121112;gm. Rabka-Zdrój;nowotarski;Nowy Sącz;16915;13851;13731;120
121113;gm. Spytkowice;nowotarski;Nowy Sącz;4714;3571;3539;32
121114;gm. Szaflary;nowotarski;Nowy Sącz;10900;8582;8489;93
Powiat olkuski;;;;108915;90161;89471;690
121201;m. Bukowno;olkuski;Kraków;9801;8306;8224;82
121203;gm. Bolesław;olkuski;Kraków;7695;6374;6249;125
121204;gm. Klucze;olkuski;Kraków;14915;12288;12129;159
121205;gm. Olkusz;olkuski;Kraków;47001;38920;38729;191
121206;gm. Trzyciąż;olkuski;Kraków;7105;5726;5663;63
121207;gm. Wolbrom;olkuski;Kraków;22398;18547;18477;70
Powiat oświęcimski;;;;150096;122600;121832;768
121301;m. Oświęcim;oświęcimski;Kraków;36289;30391;30133;258
121302;gm. Brzeszcze;oświęcimski;Kraków;20833;17117;16967;150
121303;gm. Chełmek;oświęcimski;Kraków;12599;10356;10289;67
121304;gm. Kęty;oświęcimski;Kraków;33236;26867;26751;116
121305;gm. Osiek;oświęcimski;Kraków;8192;6538;6525;13
121306;gm. Oświęcim;oświęcimski;Kraków;18562;14930;14840;90
121307;gm. Polanka Wielka;oświęcimski;Kraków;4315;3446;3440;6
121308;gm. Przeciszów;oświęcimski;Kraków;6795;5475;5459;16
121309;gm. Zator;oświęcimski;Kraków;9275;7480;7428;52
Powiat proszowicki;;;;43158;35210;34660;550
121401;gm. Koniusza;proszowicki;Kraków;8936;7058;6959;99
121402;gm. Koszyce;proszowicki;Kraków;5497;4588;4529;59
121403;gm. Nowe Brzesko;proszowicki;Kraków;5686;4678;4579;99
121404;gm. Pałecznica;proszowicki;Kraków;3634;2882;2845;37
121405;gm. Proszowice;proszowicki;Kraków;16015;13251;13066;185
121406;gm. Radziemice;proszowicki;Kraków;3390;2753;2682;71
Powiat suski;;;;84218;66933;66179;754
121501;m. Jordanów;suski;Nowy Sącz;5321;4252;4186;66
121502;m. Sucha Beskidzka;suski;Nowy Sącz;9003;7435;7335;100
121503;gm. Budzów;suski;Nowy Sącz;8932;6830;6790;40
121504;gm. Bystra-Sidzina;suski;Nowy Sącz;6943;5416;5379;37
121505;gm. Jordanów;suski;Nowy Sącz;11146;8728;8654;74
121506;gm. Maków Podhalański;suski;Nowy Sącz;15939;12729;12610;119
121507;gm. Stryszawa;suski;Nowy Sącz;12117;9701;9562;139
121508;gm. Zawoja;suski;Nowy Sącz;9168;7280;7156;124
121509;gm. Zembrzyce;suski;Nowy Sącz;5649;4562;4507;55
Powiat tarnowski;;;;201120;160640;159626;1014
121601;gm. Ciężkowice;tarnowski;Tarnów;11392;8940;8882;58
121602;gm. Gromnik;tarnowski;Tarnów;8974;6990;6960;30
121603;gm. Lisia Góra;tarnowski;Tarnów;15417;11973;11901;72
121604;gm. Pleśna;tarnowski;Tarnów;11998;9580;9536;44
121605;gm. Radłów;tarnowski;Tarnów;9617;7875;7832;43
121606;gm. Ryglice;tarnowski;Tarnów;11672;9215;9180;35
121607;gm. Rzepiennik Strzyżewski;tarnowski;Tarnów;6813;5418;5357;61
121608;gm. Skrzyszów;tarnowski;Tarnów;14285;11318;11279;39
121609;gm. Tarnów;tarnowski;Tarnów;25596;20614;20483;131
121610;gm. Tuchów;tarnowski;Tarnów;17901;14227;14074;153
121611;gm. Wierzchosławice;tarnowski;Tarnów;10788;8744;8680;64
121612;gm. Wietrzychowice;tarnowski;Tarnów;3933;3336;3318;18
121613;gm. Wojnicz;tarnowski;Tarnów;13471;10834;10753;81
121614;gm. Zakliczyn;tarnowski;Tarnów;12584;9804;9704;100
121615;gm. Żabno;tarnowski;Tarnów;18725;15403;15344;59
121616;gm. Szerzyny;tarnowski;Tarnów;7954;6369;6343;26
Powiat tatrzański;;;;66506;53187;52710;477
121701;m. Zakopane;tatrzański;Nowy Sącz;25937;21403;21162;241
121702;gm. Biały Dunajec;tatrzański;Nowy Sącz;7099;5589;5567;22
121703;gm. Bukowina Tatrzańska;tatrzański;Nowy Sącz;13377;10416;10356;60
121704;gm. Kościelisko;tatrzański;Nowy Sącz;8564;6874;6776;98
121705;gm. Poronin;tatrzański;Nowy Sącz;11529;8905;8849;56
Powiat wadowicki;;;;158113;126145;125151;994
121801;gm. Andrychów;wadowicki;Kraków;42890;34350;34189;161
121802;gm. Brzeźnica;wadowicki;Kraków;10353;8211;8052;159
121803;gm. Kalwaria Zebrzydowska;wadowicki;Kraków;19735;15877;15715;162
121804;gm. Lanckorona;wadowicki;Kraków;6192;4865;4786;79
121805;gm. Mucharz;wadowicki;Kraków;4148;3258;3230;28
121806;gm. Spytkowice;wadowicki;Kraków;10315;8201;8163;38
121807;gm. Stryszów;wadowicki;Kraków;6938;5528;5474;54
121808;gm. Tomice;wadowicki;Kraków;8027;6234;6205;29
121809;gm. Wadowice;wadowicki;Kraków;37112;29993;29742;251
121810;gm. Wieprz;wadowicki;Kraków;12403;9628;9595;33
Powiat wielicki;;;;125066;97811;96362;1449
121901;gm. Biskupice;wielicki;Kraków;10280;7933;7772;161
121902;gm. Gdów;wielicki;Kraków;18152;14171;13881;290
121903;gm. Kłaj;wielicki;Kraków;10555;8465;8291;174
121904;gm. Niepołomice;wielicki;Kraków;28060;21798;21533;265
121905;gm. Wieliczka;wielicki;Kraków;58019;45444;44885;559
Miasto na prawach powiatu;;;;;;;
126101;m. Kraków;Kraków;Kraków;713577;594541;580963;13578
Miasto na prawach powiatu;;;;;;;
126201;m. Nowy Sącz;Nowy Sącz;Nowy Sącz;80441;65071;64576;495
Miasto na prawach powiatu;;;;;;;
126301;m. Tarnów;Tarnów;Tarnów;104814;87503;86955;548
Powiat białobrzeski;;;;33706;26690;26397;293
140101;gm. Białobrzegi;białobrzeski;Radom;10169;8130;8084;46
140102;gm. Promna;białobrzeski;Radom;5630;4490;4429;61
140103;gm. Radzanów;białobrzeski;Radom;3898;3042;3005;37
140104;gm. Stara Błotnica;białobrzeski;Radom;5493;4219;4167;52
140105;gm. Stromiec;białobrzeski;Radom;5647;4493;4457;36
140106;gm. Wyśmierzyce;białobrzeski;Radom;2869;2316;2255;61
Powiat ciechanowski;;;;87870;71693;71192;501
140201;m. Ciechanów;ciechanowski;Ciechanów;42618;35201;35088;113
140202;gm. Ciechanów;ciechanowski;Ciechanów;7076;5658;5630;28
140203;gm. Glinojeck;ciechanowski;Ciechanów;7722;6210;6128;82
140204;gm. Gołymin-Ośrodek;ciechanowski;Ciechanów;3883;3109;3074;35
140205;gm. Grudusk;ciechanowski;Ciechanów;3601;2940;2931;9
140206;gm. Ojrzeń;ciechanowski;Ciechanów;4351;3502;3432;70
140207;gm. Opinogóra Górna;ciechanowski;Ciechanów;5964;4784;4764;20
140208;gm. Regimin;ciechanowski;Ciechanów;5040;4075;3980;95
140209;gm. Sońsk;ciechanowski;Ciechanów;7615;6214;6165;49
Powiat garwoliński;;;;109300;85685;84704;981
140301;m. Garwolin;garwoliński;Siedlce;17260;13457;13361;96
140302;m. Łaskarzew;garwoliński;Siedlce;4826;3931;3844;87
140303;gm. Borowie;garwoliński;Siedlce;5269;4209;4128;81
140304;gm. Garwolin;garwoliński;Siedlce;13321;10094;10028;66
140305;gm. Górzno;garwoliński;Siedlce;6563;5062;5036;26
140306;gm. Łaskarzew;garwoliński;Siedlce;5426;4283;4259;24
140307;gm. Maciejowice;garwoliński;Siedlce;7068;5751;5704;47
140308;gm. Miastków Kościelny;garwoliński;Siedlce;4871;3838;3797;41
140309;gm. Parysów;garwoliński;Siedlce;4231;3248;3157;91
140310;gm. Pilawa;garwoliński;Siedlce;11010;8536;8395;141
140311;gm. Sobolew;garwoliński;Siedlce;8285;6436;6393;43
140312;gm. Trojanów;garwoliński;Siedlce;7423;5891;5850;41
140313;gm. Wilga;garwoliński;Siedlce;5286;4284;4156;128
140314;gm. Żelechów;garwoliński;Siedlce;8461;6665;6596;69
Powiat gostyniński;;;;44318;36643;36263;380
140401;m. Gostynin;gostyniński;Płock;17613;14779;14722;57
140402;gm. Gostynin;gostyniński;Płock;12095;9849;9716;133
140403;gm. Pacyna;gostyniński;Płock;3566;2965;2873;92
140404;gm. Sanniki;gostyniński;Płock;6067;4984;4937;47
140405;gm. Szczawin Kośc.;gostyniński;Płock;4977;4066;4015;51
Powiat grodziski;;;;91697;71941;69589;2352
140501;m. Milanówek;grodziski;Warszawa;15849;12878;12346;532
140502;m. Podkowa Leśna;grodziski;Warszawa;3874;3175;2881;294
140503;gm. Baranów;grodziski;Warszawa;5313;4168;4058;110
140504;gm. Grodzisk Mazowiecki;grodziski;Warszawa;45546;35272;34556;716
140505;gm. Jaktorów;grodziski;Warszawa;12192;9541;9335;206
140506;gm. Żabia Wola;grodziski;Warszawa;8923;6907;6413;494
Powiat grójecki;;;;97359;78432;76897;1535
140601;gm. Belsk Duży;grójecki;Radom;6478;5282;5230;52
140602;gm. Błędów;grójecki;Radom;7481;6120;6073;47
140603;gm. Chynów;grójecki;Radom;9888;7867;7636;231
140604;gm. Goszczyn;grójecki;Radom;2998;2365;2238;127
140605;gm. Grójec;grójecki;Radom;24884;19788;19357;431
140606;gm. Jasieniec;grójecki;Radom;5376;4296;4226;70
140607;gm. Mogielnica;grójecki;Radom;8758;7236;7130;106
140608;gm. Nowe Miasto nad Pilicą;grójecki;Radom;7723;6479;6312;167
140609;gm. Pniewy;grójecki;Radom;4847;3871;3675;196
140611;gm. Warka;grójecki;Radom;18926;15128;15020;108
Powiat kozienicki;;;;60353;49741;48687;1054
140701;gm. Garbatka-Letnisko;kozienicki;Radom;5036;4229;4088;141
140702;gm. Głowaczów;kozienicki;Radom;7331;5981;5798;183
140703;gm. Gniewoszów;kozienicki;Radom;3909;3206;3162;44
140704;gm. Grabów nad Pilicą;kozienicki;Radom;4010;3223;3032;191
140705;gm. Kozienice;kozienicki;Radom;29125;24153;24014;139
140706;gm. Magnuszew;kozienicki;Radom;6993;5677;5402;275
140707;gm. Sieciechów;kozienicki;Radom;3949;3272;3191;81
Powiat legionowski;;;;113561;89062;85632;3430
140801;m. Legionowo;legionowski;Warszawa;50796;40408;39850;558
140802;gm. Jabłonna;legionowski;Warszawa;18521;14009;13258;751
140803;gm. Nieporęt;legionowski;Warszawa;14508;11409;10561;848
140804;gm. Serock;legionowski;Warszawa;14969;11852;11075;777
140805;gm. Wieliszew;legionowski;Warszawa;14767;11384;10888;496
Powiat lipski;;;;34312;28439;28217;222
140901;gm. Chotcza;lipski;Radom;2382;1974;1946;28
140902;gm. Ciepielów;lipski;Radom;5666;4597;4573;24
140903;gm. Lipsko;lipski;Radom;11001;9189;9143;46
140904;gm. Rzeczniów;lipski;Radom;4379;3614;3598;16
140905;gm. Sienno;lipski;Radom;5876;4860;4793;67
140906;gm. Solec nad Wisłą;lipski;Radom;5008;4205;4164;41
Powiat łosicki;;;;31291;25444;25216;228
141001;gm. Huszlew;łosicki;Siedlce;2844;2268;2254;14
141002;gm. Łosice;łosicki;Siedlce;10957;8888;8838;50
141003;gm. Olszanka;łosicki;Siedlce;3038;2408;2394;14
141004;gm. Platerów;łosicki;Siedlce;4900;3974;3945;29
141005;gm. Sarnaki;łosicki;Siedlce;4763;4004;3906;98
141006;gm. Stara Kornica;łosicki;Siedlce;4789;3902;3879;23
Powiat makowski;;;;44983;36338;35861;477
141101;m. Maków Mazowiecki;makowski;Ostrołęka;9330;7637;7592;45
141102;gm. Czerwonka;makowski;Ostrołęka;2691;2149;2093;56
141103;gm. Karniewo;makowski;Ostrołęka;5232;4177;4141;36
141104;gm. Krasnosielc;makowski;Ostrołęka;6443;5156;5117;39
141105;gm. Młynarze;makowski;Ostrołęka;1753;1379;1347;32
141106;gm. Płoniawy-Bramura;makowski;Ostrołęka;5419;4438;4401;37
141107;gm. Różan;makowski;Ostrołęka;4462;3604;3492;112
141108;gm. Rzewnie;makowski;Ostrołęka;2703;2193;2129;64
141109;gm. Sypniewo;makowski;Ostrołęka;3297;2662;2644;18
141110;gm. Szelków;makowski;Ostrołęka;3653;2943;2905;38
Powiat miński;;;;150710;118613;116625;1988
141201;m. Mińsk Mazowiecki;miński;Siedlce;39012;30693;30453;240
141204;gm. Cegłów;miński;Siedlce;6053;4839;4777;62
141205;gm. Dębe Wielkie;miński;Siedlce;10420;7978;7719;259
141206;gm. Dobre;miński;Siedlce;6046;4834;4693;141
141207;gm. Halinów;miński;Siedlce;15822;12097;11756;341
141208;gm. Jakubów;miński;Siedlce;5110;3995;3926;69
141209;gm. Kałuszyn;miński;Siedlce;5781;4664;4618;46
141210;gm. Latowicz;miński;Siedlce;5377;4218;4186;32
141211;gm. Mińsk Mazowiecki;miński;Siedlce;15098;11806;11684;122
141212;gm. Mrozy;miński;Siedlce;8617;6874;6805;69
141213;gm. Siennica;miński;Siedlce;7385;5799;5693;106
141214;gm. Stanisławów;miński;Siedlce;6774;5383;5225;158
141215;m. Sulejówek;miński;Siedlce;19215;15433;15090;343
Powiat mławski;;;;71420;57836;57243;593
141301;m. Mława;mławski;Ciechanów;29714;24182;24074;108
141302;gm. Dzierzgowo;mławski;Ciechanów;3063;2479;2446;33
141303;gm. Lipowiec Kościelny;mławski;Ciechanów;4810;3924;3884;40
141304;gm. Radzanów;mławski;Ciechanów;3432;2770;2672;98
141305;gm. Strzegowo;mławski;Ciechanów;7619;6197;6128;69
141306;gm. Stupsk;mławski;Ciechanów;4816;3892;3841;51
141307;gm. Szreńsk;mławski;Ciechanów;4213;3403;3349;54
141308;gm. Szydłowo;mławski;Ciechanów;4579;3691;3627;64
141309;gm. Wieczfnia Kościelna;mławski;Ciechanów;4012;3169;3129;40
141310;gm. Wiśniewo;mławski;Ciechanów;5162;4129;4093;36
Powiat nowodworski;;;;77256;62380;60020;2360
141401;m. Nowy Dwór Mazowiecki;nowodworski;Warszawa;26979;21640;21309;331
141402;gm. Czosnów;nowodworski;Warszawa;9953;8085;7291;794
141403;gm. Leoncin;nowodworski;Warszawa;5583;4534;4155;379
141404;gm. Nasielsk;nowodworski;Warszawa;19591;15697;15414;283
141405;gm. Pomiechówek;nowodworski;Warszawa;8974;7312;7053;259
141406;gm. Zakroczym;nowodworski;Warszawa;6176;5112;4798;314
Powiat ostrołęcki;;;;89177;70332;69437;895
141501;gm. Baranowo;ostrołęcki;Ostrołęka;6545;5298;5240;58
141502;gm. Czarnia;ostrołęcki;Ostrołęka;2581;1997;1978;19
141503;gm. Czerwin;ostrołęcki;Ostrołęka;5191;4174;4090;84
141504;gm. Goworowo;ostrołęcki;Ostrołęka;8420;6796;6697;99
141505;gm. Kadzidło;ostrołęcki;Ostrołęka;11390;8988;8937;51
141506;gm. Lelis;ostrołęcki;Ostrołęka;9712;7498;7415;83
141507;gm. Łyse;ostrołęcki;Ostrołęka;8477;6595;6566;29
141508;gm. Myszyniec;ostrołęcki;Ostrołęka;10612;8367;8285;82
141509;gm. Olszewo-Borki;ostrołęcki;Ostrołęka;10779;8467;8291;176
141510;gm. Rzekuń;ostrołęcki;Ostrołęka;10696;8335;8173;162
141511;gm. Troszyn;ostrołęcki;Ostrołęka;4774;3817;3765;52
Powiat ostrowski;;;;72377;58942;58180;762
141601;m. Ostrów Mazowiecka;ostrowski;Ostrołęka;21970;17994;17841;153
141602;gm. Andrzejewo;ostrowski;Ostrołęka;4189;3431;3358;73
141603;gm. Boguty-Pianki;ostrowski;Ostrołęka;2608;2158;2143;15
141604;gm. Brok;ostrowski;Ostrołęka;2820;2335;2255;80
141605;gm. Małkinia Górna;ostrowski;Ostrołęka;11671;9460;9382;78
141606;gm. Nur;ostrowski;Ostrołęka;2786;2373;2328;45
141607;gm. Ostrów Mazowiecka;ostrowski;Ostrołęka;12857;10304;10172;132
141608;gm. Stary Lubotyń;ostrowski;Ostrołęka;3756;2971;2946;25
141609;gm. Szulborze Wielkie;ostrowski;Ostrołęka;1705;1394;1375;19
141610;gm. Wąsewo;ostrowski;Ostrołęka;4343;3528;3470;58
141611;gm. Zaręby Kościelne;ostrowski;Ostrołęka;3672;2994;2910;84
Powiat otwocki;;;;120054;95442;93604;1838
141701;m. Józefów;otwocki;Warszawa;19538;15102;14779;323
141702;m. Otwock;otwocki;Warszawa;42529;34331;33717;614
141703;gm. Celestynów;otwocki;Warszawa;11644;9304;9167;137
141704;gm. Karczew;otwocki;Warszawa;15380;12523;12385;138
141705;gm. Kołbiel;otwocki;Warszawa;8238;6505;6421;84
141706;gm. Osieck;otwocki;Warszawa;3655;2889;2865;24
141707;gm. Sobienie-Jeziory;otwocki;Warszawa;6345;5088;5034;54
141708;gm. Wiązowna;otwocki;Warszawa;12725;9700;9236;464
Powiat piaseczyński;;;;176728;135795;131112;4683
141801;gm. Góra Kalwaria;piaseczyński;Warszawa;26166;20804;20310;494
141802;gm. Konstancin-Jeziorna;piaseczyński;Warszawa;23580;19175;18466;709
141803;gm. Lesznowola;piaseczyński;Warszawa;26585;19074;18222;852
141804;gm. Piaseczno;piaseczyński;Warszawa;78215;59310;57511;1799
141805;gm. Prażmów;piaseczyński;Warszawa;10925;8522;8097;425
141806;gm. Tarczyn;piaseczyński;Warszawa;11257;8910;8506;404
Powiat płocki;;;;109921;88786;87457;1329
141901;gm. Bielsk;płocki;Płock;8958;7135;7010;125
141902;gm. Bodzanów;płocki;Płock;8163;6662;6576;86
141903;gm. Brudzeń Duży;płocki;Płock;8197;6563;6500;63
141904;gm. Bulkowo;płocki;Płock;5621;4549;4480;69
141905;gm. Drobin;płocki;Płock;7875;6254;6197;57
141906;gm. Gąbin;płocki;Płock;10885;8947;8876;71
141907;gm. Łąck;płocki;Płock;5367;4409;4274;135
141908;gm. Mała Wieś;płocki;Płock;5972;4906;4830;76
141909;gm. Nowy Duninów;płocki;Płock;3945;3206;3143;63
141910;gm. Radzanowo;płocki;Płock;8215;6618;6510;108
141911;gm. Słubice;płocki;Płock;4436;3625;3587;38
141912;gm. Słupno;płocki;Płock;7908;6302;6029;273
141913;gm. Stara Biała;płocki;Płock;11582;9192;9138;54
141914;gm. Staroźreby;płocki;Płock;7218;5835;5778;57
141915;gm. Wyszogród;płocki;Płock;5579;4583;4529;54
Powiat płoński;;;;85773;69610;68566;1044
142001;m. Płońsk;płoński;Ciechanów;21176;17277;17144;133
142002;m. Raciąż;płoński;Ciechanów;4356;3613;3483;130
142003;gm. Baboszewo;płoński;Ciechanów;7940;6374;6308;66
142004;gm. Czerwińsk nad Wisłą;płoński;Ciechanów;7598;6145;6082;63
142005;gm. Dzierzążnia;płoński;Ciechanów;3683;3023;2978;45
142006;gm. Joniec;płoński;Ciechanów;2640;2147;2066;81
142007;gm. Naruszewo;płoński;Ciechanów;6330;5108;5043;65
142008;gm. Nowe Miasto;płoński;Ciechanów;4572;3765;3664;101
142009;gm. Płońsk;płoński;Ciechanów;7877;6321;6244;77
142010;gm. Raciąż;płoński;Ciechanów;8073;6557;6503;54
142011;gm. Sochocin;płoński;Ciechanów;5870;4757;4609;148
142012;gm. Załuski;płoński;Ciechanów;5658;4523;4442;81
Powiat pruszkowski;;;;157943;124798;120993;3805
142101;m. Piastów;pruszkowski;Warszawa;21712;17650;17420;230
142102;m. Pruszków;pruszkowski;Warszawa;57918;45866;45230;636
142103;gm. Brwinów;pruszkowski;Warszawa;25558;20057;19284;773
142104;gm. Michałowice;pruszkowski;Warszawa;17710;13822;13323;499
142105;gm. Nadarzyn;pruszkowski;Warszawa;14036;10841;9724;1117
142106;gm. Raszyn;pruszkowski;Warszawa;21009;16562;16012;550
Powiat przasnyski;;;;52190;41557;41193;364
142201;m. Przasnysz;przasnyski;Ciechanów;16518;13339;13237;102
142202;gm. Chorzele;przasnyski;Ciechanów;10160;7981;7939;42
142203;gm. Czernice Borowe;przasnyski;Ciechanów;3777;3054;3020;34
142204;gm. Jednorożec;przasnyski;Ciechanów;7200;5657;5604;53
142205;gm. Krasne;przasnyski;Ciechanów;3695;2976;2958;18
142206;gm. Krzynowłoga Mała;przasnyski;Ciechanów;3572;2855;2773;82
142207;gm. Przasnysz;przasnyski;Ciechanów;7268;5695;5662;33
Powiat przysuski;;;;42241;34853;34244;609
142301;gm. Borkowice;przysuski;Radom;4362;3626;3534;92
142302;gm. Gielniów;przysuski;Radom;4582;3814;3715;99
142303;gm. Klwów;przysuski;Radom;3450;2752;2691;61
142304;gm. Odrzywół;przysuski;Radom;3810;3214;3124;90
142305;gm. Potworów;przysuski;Radom;4203;3350;3314;36
142306;gm. Przysucha;przysuski;Radom;11988;10114;10017;97
142307;gm. Rusinów;przysuski;Radom;4356;3575;3530;45
142308;gm. Wieniawa;przysuski;Radom;5490;4408;4319;89
Powiat pułtuski;;;;51350;41184;40335;849
142401;gm. Gzy;pułtuski;Ostrołęka;3764;3026;3000;26
142402;gm. Obryte;pułtuski;Ostrołęka;4895;3920;3789;131
142403;gm. Pokrzywnica;pułtuski;Ostrołęka;5071;4007;3847;160
142404;gm. Pułtusk;pułtuski;Ostrołęka;23859;19226;18971;255
142405;gm. Świercze;pułtuski;Ostrołęka;4728;3851;3718;133
142406;gm. Winnica;pułtuski;Ostrołęka;4141;3249;3221;28
142407;gm. Zatory;pułtuski;Ostrołęka;4892;3905;3789;116
Powiat radomski;;;;152135;120676;118897;1779
142501;m. Pionki;radomski;Radom;17586;14941;14878;63
142502;gm. Gózd;radomski;Radom;9041;6982;6829;153
142503;gm. Iłża;radomski;Radom;14787;12204;12169;35
142504;gm. Jastrzębia;radomski;Radom;7105;5569;5393;176
142505;gm. Jedlińsk;radomski;Radom;14443;11147;11028;119
142506;gm. Jedlnia-Letnisko;radomski;Radom;12960;10279;10063;216
142507;gm. Kowala;radomski;Radom;12133;9415;9188;227
142508;gm. Pionki;radomski;Radom;10076;8129;8042;87
142509;gm. Przytyk;radomski;Radom;7369;5738;5644;94
142510;gm. Skaryszew;radomski;Radom;14855;11423;11251;172
142511;gm. Wierzbica;radomski;Radom;9685;7746;7707;39
142512;gm. Wolanów;radomski;Radom;8996;7026;6826;200
142513;gm. Zakrzew;radomski;Radom;13099;10077;9879;198
Powiat siedlecki;;;;81886;65032;64381;651
142601;gm. Domanice;siedlecki;Siedlce;2680;2112;2069;43
142602;gm. Korczew;siedlecki;Siedlce;2651;2226;2191;35
142603;gm. Kotuń;siedlecki;Siedlce;8552;6827;6748;79
142604;gm. Mokobody;siedlecki;Siedlce;5017;4061;4004;57
142605;gm. Mordy;siedlecki;Siedlce;5854;4752;4694;58
142606;gm. Paprotnia;siedlecki;Siedlce;2617;2106;2074;32
142607;gm. Przesmyki;siedlecki;Siedlce;3245;2680;2648;32
142608;gm. Siedlce;siedlecki;Siedlce;18241;14202;14111;91
142609;gm. Skórzec;siedlecki;Siedlce;7884;6150;6094;56
142610;gm. Suchożebry;siedlecki;Siedlce;4722;3765;3719;46
142611;gm. Wiśniew;siedlecki;Siedlce;5846;4618;4587;31
142612;gm. Wodynie;siedlecki;Siedlce;4417;3595;3556;39
142613;gm. Zbuczyn;siedlecki;Siedlce;10160;7938;7886;52
Powiat sierpecki;;;;51473;41802;41192;610
142701;m. Sierpc;sierpecki;Płock;17468;14433;14352;81
142702;gm. Gozdowo;sierpecki;Płock;5951;4742;4676;66
142703;gm. Mochowo;sierpecki;Płock;6080;4894;4738;156
142704;gm. Rościszewo;sierpecki;Płock;4147;3365;3323;42
142705;gm. Sierpc;sierpecki;Płock;6894;5490;5430;60
142706;gm. Szczutowo;sierpecki;Płock;4342;3504;3405;99
142707;gm. Zawidz;sierpecki;Płock;6591;5374;5268;106
Powiat sochaczewski;;;;82339;66483;65787;696
142801;m. Sochaczew;sochaczewski;Płock;33924;27924;27770;154
142802;gm. Brochów;sochaczewski;Płock;4411;3580;3446;134
142803;gm. Iłów;sochaczewski;Płock;6139;4974;4908;66
142804;gm. Młodzieszyn;sochaczewski;Płock;5521;4456;4412;44
142805;gm. Nowa Sucha;sochaczewski;Płock;6692;5258;5185;73
142806;gm. Rybno;sochaczewski;Płock;3498;2758;2719;39
142807;gm. Sochaczew;sochaczewski;Płock;10785;8424;8369;55
142808;gm. Teresin;sochaczewski;Płock;11369;9109;8978;131
Powiat sokołowski;;;;54410;44728;44143;585
142901;m. Sokołów Podlaski;sokołowski;Siedlce;18714;15260;15087;173
142902;gm. Bielany;sokołowski;Siedlce;3755;3009;2958;51
142903;gm. Ceranów;sokołowski;Siedlce;2226;1889;1856;33
142904;gm. Jabłonna Lacka;sokołowski;Siedlce;4571;3788;3728;60
142905;gm. Kosów Lacki;sokołowski;Siedlce;6083;5047;5016;31
142906;gm. Repki;sokołowski;Siedlce;5229;4337;4282;55
142907;gm. Sabnie;sokołowski;Siedlce;3746;3086;3048;38
142908;gm. Sokołów Podlaski;sokołowski;Siedlce;6121;4960;4856;104
142909;gm. Sterdyń;sokołowski;Siedlce;3965;3352;3312;40
Powiat szydłowiecki;;;;39569;32224;31580;644
143001;gm. Chlewiska;szydłowiecki;Radom;6089;5102;4844;258
143002;gm. Jastrząb;szydłowiecki;Radom;5230;4217;4092;125
143003;gm. Mirów;szydłowiecki;Radom;3916;3079;3007;72
143004;gm. Orońsko;szydłowiecki;Radom;5954;4705;4616;89
143005;gm. Szydłowiec;szydłowiecki;Radom;18380;15121;15021;100
Powiat warszawski zachodni;;;;114162;89648;86252;3396
143201;gm. Błonie;warszawski zachodni;Warszawa;20936;16648;16315;333
143202;gm. Izabelin;warszawski zachodni;Warszawa;10295;8278;7859;419
143203;gm. Kampinos;warszawski zachodni;Warszawa;4366;3584;3399;185
143204;gm. Leszno;warszawski zachodni;Warszawa;9796;7830;7505;325
143205;gm. Łomianki;warszawski zachodni;Warszawa;26149;20429;19316;1113
143206;gm. Ożarów Mazowiecki;warszawski zachodni;Warszawa;24205;18614;18226;388
143207;gm. Stare Babice;warszawski zachodni;Warszawa;18415;14265;13632;633
Powiat węgrowski;;;;66167;53420;52892;528
143301;m. Węgrów;węgrowski;Siedlce;12679;10239;10190;49
143302;gm. Grębków;węgrowski;Siedlce;4490;3586;3552;34
143303;gm. Korytnica;węgrowski;Siedlce;6234;5039;4981;58
143304;gm. Liw;węgrowski;Siedlce;7402;6013;5995;18
143305;gm. Łochów;węgrowski;Siedlce;17768;14178;14008;170
143306;gm. Miedzna;węgrowski;Siedlce;3959;3273;3233;40
143307;gm. Sadowne;węgrowski;Siedlce;5929;4785;4706;79
143308;gm. Stoczek;węgrowski;Siedlce;4931;4007;3970;37
143309;gm. Wierzbno;węgrowski;Siedlce;2775;2300;2257;43
Powiat wołomiński;;;;238817;183424;179652;3772
143401;m. Kobyłka;wołomiński;Warszawa;23466;17802;17453;349
143402;m. Marki;wołomiński;Warszawa;33124;24542;24003;539
143403;m. Ząbki;wołomiński;Warszawa;34820;25495;24865;630
143404;m. Zielonka;wołomiński;Warszawa;16961;13619;13315;304
143405;gm. Dąbrówka;wołomiński;Warszawa;8029;6191;6060;131
143406;gm. Jadów;wołomiński;Warszawa;7552;6092;5882;210
143407;gm. Klembów;wołomiński;Warszawa;9864;7607;7432;175
143408;gm. Poświętne;wołomiński;Warszawa;6252;4868;4752;116
143409;gm. Radzymin;wołomiński;Warszawa;26515;19860;19282;578
143410;gm. Strachówka;wołomiński;Warszawa;2821;2303;2194;109
143411;gm. Tłuszcz;wołomiński;Warszawa;19853;15569;15380;189
143412;gm. Wołomin;wołomiński;Warszawa;49560;39476;39034;442
Powiat wyszkowski;;;;73537;58252;57376;876
143501;gm. Brańszczyk;wyszkowski;Ostrołęka;8209;6626;6488;138
143502;gm. Długosiodło;wyszkowski;Ostrołęka;7797;6167;6044;123
143503;gm. Rząśnik;wyszkowski;Ostrołęka;7042;5518;5435;83
143504;gm. Somianka;wyszkowski;Ostrołęka;5653;4472;4362;110
143505;gm. Wyszków;wyszkowski;Ostrołęka;38790;30772;30515;257
143506;gm. Zabrodzie;wyszkowski;Ostrołęka;6046;4697;4532;165
Powiat zwoleński;;;;36643;29651;29280;371
143601;gm. Kazanów;zwoleński;Radom;4637;3713;3628;85
143602;gm. Policzna;zwoleński;Radom;5735;4739;4623;116
143603;gm. Przyłęk;zwoleński;Radom;6175;5012;4945;67
143604;gm. Tczów;zwoleński;Radom;4964;3865;3831;34
143605;gm. Zwoleń;zwoleński;Radom;15132;12322;12253;69
Powiat żuromiński;;;;38777;31528;31278;250
143701;gm. Bieżuń;żuromiński;Ciechanów;4936;4039;4005;34
143702;gm. Kuczbork-Osada;żuromiński;Ciechanów;4771;3848;3833;15
143703;gm. Lubowidz;żuromiński;Ciechanów;6916;5595;5581;14
143704;gm. Lutocin;żuromiński;Ciechanów;4436;3577;3565;12
143705;gm. Siemiątkowo;żuromiński;Ciechanów;3527;2828;2726;102
143706;gm. Żuromin;żuromiński;Ciechanów;14191;11641;11568;73
Powiat żyrardowski;;;;72535;58372;57310;1062
143801;m. Żyrardów;żyrardowski;Płock;37223;30183;29881;302
143802;gm. Mszczonów;żyrardowski;Płock;11320;9043;8891;152
143803;gm. Puszcza Mariańska;żyrardowski;Płock;8467;6764;6644;120
143804;gm. Radziejowice;żyrardowski;Płock;5704;4463;4287;176
143805;gm. Wiskitki;żyrardowski;Płock;9821;7919;7607;312
Miasto na prawach powiatu;;;;;;;
146101;m. Ostrołęka;Ostrołęka;Ostrołęka;51227;40953;40468;485
Miasto na prawach powiatu;;;;;;;
146201;m. Płock;Płock;Płock;113453;93803;93236;567
Miasto na prawach powiatu;;;;;;;
146301;m. Radom;Radom;Radom;197184;162964;162324;640
Miasto na prawach powiatu;;;;;;;
146401;m. Siedlce;Siedlce;Siedlce;73856;58908;58387;521
Miasto stołeczne Warszawa;;;;1666621;1342650;1294399;48251
146502;Bemowo;Warszawa;Warszawa;118558;93568;90905;2663
146503;Białołęka;Warszawa;Warszawa;118787;85995;83688;2307
146504;Bielany;Warszawa;Warszawa;124144;102612;99376;3236
146505;Mokotów;Warszawa;Warszawa;203285;167954;161299;6655
146506;Ochota;Warszawa;Warszawa;75101;62196;59547;2649
146507;Praga-Południe;Warszawa;Warszawa;169683;139591;136274;3317
146508;Praga-Północ;Warszawa;Warszawa;57447;48042;46265;1777
146509;Rembertów;Warszawa;Warszawa;22652;18052;17562;490
146510;Śródmieście;Warszawa;Warszawa;101613;86843;82856;3987
146511;Targówek;Warszawa;Warszawa;117508;96129;94306;1823
146512;Ursus;Warszawa;Warszawa;56934;43507;41830;1677
146513;Ursynów;Warszawa;Warszawa;141853;112484;108611;3873
146514;Wawer;Warszawa;Warszawa;74559;58231;56247;1984
146515;Wesoła;Warszawa;Warszawa;24267;18896;17948;948
146516;Wilanów;Warszawa;Warszawa;39885;28098;26311;1787
146517;Włochy;Warszawa;Warszawa;40612;31977;30290;1687
146518;Wola;Warszawa;Warszawa;129359;107359;102370;4989
146519;Żoliborz;Warszawa;Warszawa;50374;41116;38714;2402
Powiat brzeski;;;;86186;70530;70144;386
160101;m. Brzeg;brzeski;Opole;33546;27802;27667;135
160102;gm. Skarbimierz;brzeski;Opole;7774;6179;6117;62
160103;gm. Grodków;brzeski;Opole;18802;15236;15198;38
160104;gm. Lewin Brzeski;brzeski;Opole;12506;10252;10201;51
160105;gm. Lubsza;brzeski;Opole;8755;7146;7084;62
160106;gm. Olszanka;brzeski;Opole;4803;3915;3877;38
Powiat głubczycki;;;;44095;36638;36389;249
160201;gm. Baborów;głubczycki;Opole;5890;4947;4939;8
160202;gm. Branice;głubczycki;Opole;6362;5301;5239;62
160203;gm. Głubczyce;głubczycki;Opole;21372;17663;17526;137
160204;gm. Kietrz;głubczycki;Opole;10471;8727;8685;42
Powiat kędzierzyńsko-kozielski;;;;87910;74273;73986;287
160301;m. Kędzierzyn-Koźle;kędzierzyńsko-kozielski;Opole;55685;47238;47112;126
160302;gm. Bierawa;kędzierzyńsko-kozielski;Opole;7438;6185;6105;80
160303;gm. Cisek;kędzierzyńsko-kozielski;Opole;5447;4557;4542;15
160304;gm. Pawłowiczki;kędzierzyńsko-kozielski;Opole;7300;6109;6089;20
160305;gm. Polska Cerekiew;kędzierzyńsko-kozielski;Opole;3959;3410;3390;20
160306;gm. Reńska Wieś;kędzierzyńsko-kozielski;Opole;8081;6774;6748;26
Powiat kluczborski;;;;62723;52570;52302;268
160401;gm. Byczyna;kluczborski;Opole;9051;7484;7425;59
160402;gm. Kluczbork;kluczborski;Opole;34117;28785;28659;126
160403;gm. Lasowice Wielkie;kluczborski;Opole;6642;5638;5613;25
160404;gm. Wołczyn;kluczborski;Opole;12913;10663;10605;58
Powiat krapkowicki;;;;60829;50735;50490;245
160501;gm. Gogolin;krapkowicki;Opole;12098;9946;9872;74
160502;gm. Krapkowice;krapkowicki;Opole;21706;18277;18155;122
160503;gm. Strzeleczki;krapkowicki;Opole;7201;5977;5961;16
160504;gm. Walce;krapkowicki;Opole;5395;4496;4482;14
160505;gm. Zdzieszowice;krapkowicki;Opole;14429;12039;12020;19
Powiat namysłowski;;;;41878;34230;33942;288
160601;gm. Domaszowice;namysłowski;Opole;3580;2912;2871;41
160602;gm. Namysłów;namysłowski;Opole;25454;20754;20616;138
160603;gm. Pokój;namysłowski;Opole;5091;4208;4171;37
160604;gm. Świerczów;namysłowski;Opole;3360;2825;2775;50
160605;gm. Wilków;namysłowski;Opole;4393;3531;3509;22
Powiat nyski;;;;132351;110873;110391;482
160701;gm. Głuchołazy;nyski;Opole;23197;19551;19472;79
160702;gm. Kamiennik;nyski;Opole;3401;2846;2832;14
160703;gm. Korfantów;nyski;Opole;8868;7393;7371;22
160704;gm. Łambinowice;nyski;Opole;7231;6015;5974;41
160705;gm. Nysa;nyski;Opole;54446;45767;45612;155
160706;gm. Otmuchów;nyski;Opole;13398;11117;11030;87
160707;gm. Paczków;nyski;Opole;12149;10181;10151;30
160708;gm. Pakosławice;nyski;Opole;3530;2995;2966;29
160709;gm. Skoroszyce;nyski;Opole;6131;5008;4983;25
Powiat oleski;;;;63148;52572;52336;236
160801;gm. Dobrodzień;oleski;Opole;9568;8000;7978;22
160802;gm. Gorzów Śląski;oleski;Opole;7102;5916;5882;34
160803;gm. Olesno;oleski;Opole;17205;14456;14385;71
160804;gm. Praszka;oleski;Opole;13348;11063;10997;66
160805;gm. Radłów;oleski;Opole;4222;3476;3473;3
160806;gm. Rudniki;oleski;Opole;8176;6710;6684;26
160807;gm. Zębowice;oleski;Opole;3527;2951;2937;14
Powiat opolski;;;;118678;98914;98211;703
160901;gm. Chrząstowice;opolski;Opole;6710;5573;5499;74
160902;gm. Dąbrowa;opolski;Opole;8022;6620;6565;55
160903;gm. Dobrzeń Wielki;opolski;Opole;9115;7495;7459;36
160904;gm. Komprachcice;opolski;Opole;8688;7304;7257;47
160905;gm. Łubniany;opolski;Opole;9455;7822;7725;97
160906;gm. Murów;opolski;Opole;5162;4417;4365;52
160907;gm. Niemodlin;opolski;Opole;12720;10425;10391;34
160908;gm. Ozimek;opolski;Opole;18591;15770;15713;57
160909;gm. Popielów;opolski;Opole;7788;6496;6455;41
160910;gm. Prószków;opolski;Opole;8717;7225;7177;48
160911;gm. Tarnów Opolski;opolski;Opole;9190;7683;7640;43
160912;gm. Tułowice;opolski;Opole;4991;4149;4123;26
160913;gm. Turawa;opolski;Opole;9529;7935;7842;93
Powiat prudnicki;;;;53200;44204;44038;166
161001;gm. Biała;prudnicki;Opole;10385;8616;8594;22
161002;gm. Głogówek;prudnicki;Opole;12822;10594;10521;73
161003;gm. Lubrza;prudnicki;Opole;4295;3507;3487;20
161004;gm. Prudnik;prudnicki;Opole;25698;21487;21436;51
Powiat strzelecki;;;;71988;59805;59588;217
161101;gm. Izbicko;strzelecki;Opole;5295;4357;4343;14
161102;gm. Jemielnica;strzelecki;Opole;7260;5986;5977;9
161103;gm. Kolonowskie;strzelecki;Opole;5738;4852;4834;18
161104;gm. Leśnica;strzelecki;Opole;7472;6209;6191;18
161105;gm. Strzelce Opolskie;strzelecki;Opole;28901;23962;23850;112
161106;gm. Ujazd;strzelecki;Opole;6337;5084;5049;35
161107;gm. Zawadzkie;strzelecki;Opole;10985;9355;9344;11
Miasto na prawach powiatu;;;;;;;
166101;m. Opole;Opole;Opole;119230;99105;98105;1000
Powiat bieszczadzki;;;;21838;17848;17548;300
180103;gm. Czarna;bieszczadzki;Krosno;2417;1936;1895;41
180105;gm. Lutowiska;bieszczadzki;Krosno;2137;1802;1743;59
180108;gm. Ustrzyki Dolne;bieszczadzki;Krosno;17284;14110;13910;200
Powiat brzozowski;;;;66263;52930;52515;415
180201;gm. Brzozów;brzozowski;Krosno;26877;21311;21116;195
180202;gm. Domaradz;brzozowski;Krosno;6111;4911;4866;45
180203;gm. Dydnia;brzozowski;Krosno;8053;6523;6479;44
180204;gm. Haczów;brzozowski;Krosno;9236;7386;7356;30
180205;gm. Jasienica Rosielna;brzozowski;Krosno;7845;6164;6104;60
180206;gm. Nozdrzec;brzozowski;Krosno;8141;6635;6594;41
Powiat dębicki;;;;134550;107816;107415;401
180301;m. Dębica;dębicki;Rzeszów;44344;36397;36278;119
180302;gm. Brzostek;dębicki;Rzeszów;13170;10482;10441;41
180303;gm. Czarna;dębicki;Rzeszów;13389;10490;10423;67
180304;gm. Dębica;dębicki;Rzeszów;25668;20317;20261;56
180305;gm. Jodłowa;dębicki;Rzeszów;5395;4333;4302;31
180306;gm. Pilzno;dębicki;Rzeszów;18282;14541;14503;38
180307;gm. Żyraków;dębicki;Rzeszów;14302;11256;11207;49
Powiat jarosławski;;;;119777;97407;96615;792
180401;m. Jarosław;jarosławski;Przemyśl;36353;30441;30161;280
180402;m. Radymno;jarosławski;Przemyśl;5287;4436;4386;50
180403;gm. Chłopice;jarosławski;Przemyśl;5608;4557;4531;26
180404;gm. Jarosław;jarosławski;Przemyśl;13116;10535;10504;31
180405;gm. Laszki;jarosławski;Przemyśl;6973;5544;5489;55
180406;gm. Pawłosiów;jarosławski;Przemyśl;8541;6973;6914;59
180407;gm. Pruchnik;jarosławski;Przemyśl;9835;7821;7752;69
180408;gm. Radymno;jarosławski;Przemyśl;11456;9116;9020;96
180409;gm. Rokietnica;jarosławski;Przemyśl;4496;3560;3559;1
180410;gm. Roźwienica;jarosławski;Przemyśl;6277;5060;5029;31
180411;gm. Wiązownica;jarosławski;Przemyśl;11835;9364;9270;94
Powiat jasielski;;;;113903;93166;92703;463
180501;m. Jasło;jasielski;Krosno;34610;28966;28790;176
180502;gm. Brzyska;jasielski;Krosno;6621;5299;5282;17
180503;gm. Dębowiec;jasielski;Krosno;8970;7047;7003;44
180504;gm. Jasło;jasielski;Krosno;16496;13474;13439;35
180505;gm. Kołaczyce;jasielski;Krosno;8942;7245;7211;34
180506;gm. Krempna;jasielski;Krosno;1890;1562;1546;16
180507;gm. Nowy Żmigród;jasielski;Krosno;9189;7498;7442;56
180508;gm. Osiek Jasielski;jasielski;Krosno;5369;4309;4278;31
180509;gm. Skołyszyn;jasielski;Krosno;12509;10170;10150;20
180511;gm. Tarnowiec;jasielski;Krosno;9307;7596;7562;34
Powiat kolbuszowski;;;;62847;50697;50493;204
180601;gm. Cmolas;kolbuszowski;Tarnobrzeg;8264;6580;6555;25
180602;gm. Kolbuszowa;kolbuszowski;Tarnobrzeg;24637;20221;20159;62
180603;gm. Majdan Królewski;kolbuszowski;Tarnobrzeg;10028;8031;8000;31
180604;gm. Niwiska;kolbuszowski;Tarnobrzeg;6188;4896;4869;27
180605;gm. Raniżów;kolbuszowski;Tarnobrzeg;7178;5714;5689;25
180606;gm. Dzikowiec;kolbuszowski;Tarnobrzeg;6552;5255;5221;34
Powiat krośnieński;;;;112623;90408;89930;478
180701;gm. Chorkówka;krośnieński;Krosno;13574;10820;10782;38
180702;gm. Dukla;krośnieński;Krosno;14546;11736;11654;82
180703;gm. Iwonicz-Zdrój;krośnieński;Krosno;10906;8647;8583;64
180704;gm. Jedlicze;krośnieński;Krosno;15364;12366;12328;38
180705;gm. Korczyna;krośnieński;Krosno;11360;9083;9014;69
180706;gm. Krościenko Wyżne;krośnieński;Krosno;5615;4487;4478;9
180707;gm. Miejsce Piastowe;krośnieński;Krosno;13700;11194;11093;101
180708;gm. Rymanów;krośnieński;Krosno;15986;12759;12715;44
180709;gm. Wojaszówka;krośnieński;Krosno;9366;7551;7533;18
180710;gm. Jaśliska;krośnieński;Krosno;2206;1765;1750;15
Powiat leżajski;;;;69536;56164;55803;361
180801;m. Leżajsk;leżajski;Rzeszów;13665;11497;11302;195
180802;gm. Grodzisko Dolne;leżajski;Rzeszów;8117;6567;6539;28
180803;gm. Kuryłówka;leżajski;Rzeszów;5777;4648;4601;47
180804;gm. Leżajsk;leżajski;Rzeszów;20380;16123;16086;37
180805;gm. Nowa Sarzyna;leżajski;Rzeszów;21597;17329;17275;54
Powiat lubaczowski;;;;56135;45834;45462;372
180901;m. Lubaczów;lubaczowski;Przemyśl;12016;9953;9905;48
180902;gm. Cieszanów;lubaczowski;Przemyśl;7253;5962;5918;44
180903;gm. Horyniec-Zdrój;lubaczowski;Przemyśl;4786;3948;3854;94
180904;gm. Lubaczów;lubaczowski;Przemyśl;9330;7528;7452;76
180905;gm. Narol;lubaczowski;Przemyśl;8081;6582;6555;27
180906;gm. Oleszyce;lubaczowski;Przemyśl;6459;5236;5188;48
180907;gm. Stary Dzików;lubaczowski;Przemyśl;4379;3567;3551;16
180908;gm. Wielkie Oczy;lubaczowski;Przemyśl;3831;3058;3039;19
Powiat łańcucki;;;;80508;64161;63861;300
181001;m. Łańcut;łańcucki;Rzeszów;17333;14308;14162;146
181002;gm. Białobrzegi;łańcucki;Rzeszów;8693;6801;6790;11
181003;gm. Czarna;łańcucki;Rzeszów;11734;9272;9248;24
181004;gm. Łańcut;łańcucki;Rzeszów;21721;17102;17046;56
181005;gm. Markowa;łańcucki;Rzeszów;6536;5246;5224;22
181006;gm. Rakszawa;łańcucki;Rzeszów;7443;5873;5854;19
181007;gm. Żołynia;łańcucki;Rzeszów;7048;5559;5537;22
Powiat mielecki;;;;134599;108565;108010;555
181101;m. Mielec;mielecki;Tarnobrzeg;58272;48058;47865;193
181102;gm. Borowa;mielecki;Tarnobrzeg;5562;4524;4491;33
181103;gm. Czermin;mielecki;Tarnobrzeg;7171;5711;5669;42
181104;gm. Gawłuszowice;mielecki;Tarnobrzeg;2768;2199;2179;20
181105;gm. Mielec;mielecki;Tarnobrzeg;13325;10702;10633;69
181106;gm. Padew Narodowa;mielecki;Tarnobrzeg;5418;4352;4321;31
181107;gm. Przecław;mielecki;Tarnobrzeg;12005;9330;9270;60
181108;gm. Radomyśl Wielki;mielecki;Tarnobrzeg;14212;11147;11114;33
181109;gm. Tuszów Narodowy;mielecki;Tarnobrzeg;8217;6515;6466;49
181110;gm. Wadowice Górne;mielecki;Tarnobrzeg;7649;6027;6002;25
Powiat niżański;;;;66766;54800;54366;434
181201;gm. Harasiuki;niżański;Tarnobrzeg;6171;5074;5048;26
181202;gm. Jarocin;niżański;Tarnobrzeg;5497;4515;4462;53
181203;gm. Jeżowe;niżański;Tarnobrzeg;10206;8090;8008;82
181204;gm. Krzeszów;niżański;Tarnobrzeg;4260;3524;3496;28
181205;gm. Nisko;niżański;Tarnobrzeg;22032;18199;18076;123
181206;gm. Rudnik nad Sanem;niżański;Tarnobrzeg;10119;8378;8301;77
181207;gm. Ulanów;niżański;Tarnobrzeg;8481;7020;6975;45
Powiat przemyski;;;;74616;60158;59300;858
181301;gm. Bircza;przemyski;Przemyśl;6619;5407;5267;140
181302;gm. Dubiecko;przemyski;Przemyśl;9406;7607;7533;74
181303;gm. Fredropol;przemyski;Przemyśl;5565;4507;4386;121
181304;gm. Krasiczyn;przemyski;Przemyśl;5182;4165;4024;141
181305;gm. Krzywcza;przemyski;Przemyśl;4927;3959;3939;20
181306;gm. Medyka;przemyski;Przemyśl;6496;5178;5140;38
181307;gm. Orły;przemyski;Przemyśl;8908;7090;7007;83
181308;gm. Przemyśl;przemyski;Przemyśl;10451;8508;8409;99
181309;gm. Stubno;przemyski;Przemyśl;4038;3212;3192;20
181310;gm. Żurawica;przemyski;Przemyśl;13024;10525;10403;122
Powiat przeworski;;;;78908;63785;63158;627
181401;m. Przeworsk;przeworski;Przemyśl;15139;12488;12429;59
181402;gm. Adamówka;przeworski;Przemyśl;4221;3361;3350;11
181403;gm. Gać;przeworski;Przemyśl;4672;3718;3643;75
181404;gm. Jawornik Polski;przeworski;Przemyśl;4550;3794;3663;131
181405;gm. Kańczuga;przeworski;Przemyśl;12433;10130;10003;127
181406;gm. Przeworsk;przeworski;Przemyśl;14931;11876;11825;51
181407;gm. Sieniawa;przeworski;Przemyśl;7194;5850;5737;113
181408;gm. Tryńcza;przeworski;Przemyśl;8553;6762;6735;27
181409;gm. Zarzecze;przeworski;Przemyśl;7215;5806;5773;33
Powiat ropczycko-sędziszowski;;;;74579;59126;58891;235
181501;gm. Iwierzyce;ropczycko-sędziszowski;Rzeszów;7723;6165;6110;55
181502;gm. Ostrów;ropczycko-sędziszowski;Rzeszów;7372;5866;5833;33
181503;gm. Ropczyce;ropczycko-sędziszowski;Rzeszów;27446;21633;21580;53
181504;gm. Sędziszów Małopolski;ropczycko-sędziszowski;Rzeszów;23800;18936;18857;79
181505;gm. Wielopole Skrzyńskie;ropczycko-sędziszowski;Rzeszów;8238;6526;6511;15
Powiat rzeszowski;;;;168396;133145;132338;807
181601;m. Dynów;rzeszowski;Rzeszów;6167;4991;4945;46
181602;gm. Błażowa;rzeszowski;Rzeszów;10876;8772;8728;44
181603;gm. Boguchwała;rzeszowski;Rzeszów;20488;16217;16153;64
181604;gm. Chmielnik;rzeszowski;Rzeszów;6890;5465;5385;80
181605;gm. Dynów;rzeszowski;Rzeszów;7058;5692;5666;26
181606;gm. Głogów Małopolski;rzeszowski;Rzeszów;19489;15236;15125;111
181607;gm. Hyżne;rzeszowski;Rzeszów;7069;5597;5576;21
181608;gm. Kamień;rzeszowski;Rzeszów;7045;5642;5628;14
181609;gm. Krasne;rzeszowski;Rzeszów;11477;8988;8889;99
181610;gm. Lubenia;rzeszowski;Rzeszów;6513;5266;5235;31
181611;gm. Sokołów Małopolski;rzeszowski;Rzeszów;17271;13474;13433;41
181612;gm. Świlcza;rzeszowski;Rzeszów;15833;12620;12542;78
181613;gm. Trzebownisko;rzeszowski;Rzeszów;21858;17059;16966;93
181614;gm. Tyczyn;rzeszowski;Rzeszów;10362;8126;8067;59
Powiat sanocki;;;;93632;76042;75509;533
181701;m. Sanok;sanocki;Krosno;36184;30206;29917;289
181702;gm. Besko;sanocki;Krosno;4555;3540;3525;15
181703;gm. Bukowsko;sanocki;Krosno;5552;4311;4291;20
181704;gm. Komańcza;sanocki;Krosno;4631;3898;3855;43
181705;gm. Sanok;sanocki;Krosno;18114;14385;14331;54
181706;gm. Tyrawa Wołoska;sanocki;Krosno;2055;1624;1605;19
181707;gm. Zagórz;sanocki;Krosno;13278;10620;10576;44
181708;gm. Zarszyn;sanocki;Krosno;9263;7458;7409;49
Powiat stalowowolski;;;;103215;85351;84871;480
181801;m. Stalowa Wola;stalowowolski;Tarnobrzeg;57651;48331;48075;256
181802;gm. Bojanów;stalowowolski;Tarnobrzeg;7634;6157;6123;34
181803;gm. Pysznica;stalowowolski;Tarnobrzeg;11077;9007;8966;41
181804;gm. Radomyśl nad Sanem;stalowowolski;Tarnobrzeg;7328;5962;5925;37
181805;gm. Zaklików;stalowowolski;Tarnobrzeg;8499;7005;6929;76
181806;gm. Zaleszany;stalowowolski;Tarnobrzeg;11026;8889;8853;36
Powiat strzyżowski;;;;61717;50022;49808;214
181901;gm. Czudec;strzyżowski;Rzeszów;11855;9479;9439;40
181902;gm. Frysztak;strzyżowski;Rzeszów;10551;8568;8528;40
181903;gm. Niebylec;strzyżowski;Rzeszów;10614;8576;8527;49
181904;gm. Strzyżów;strzyżowski;Rzeszów;20561;16815;16747;68
181905;gm. Wiśniowa;strzyżowski;Rzeszów;8136;6584;6567;17
Powiat tarnobrzeski;;;;52872;43588;43329;259
182001;gm. Baranów Sandomierski;tarnobrzeski;Tarnobrzeg;11938;9872;9801;71
182002;gm. Gorzyce;tarnobrzeski;Tarnobrzeg;13108;10653;10599;54
182003;gm. Grębów;tarnobrzeski;Tarnobrzeg;9968;8113;8035;78
182004;gm. Nowa Dęba;tarnobrzeski;Tarnobrzeg;17858;14950;14894;56
Powiat leski;;;;26661;22111;21794;317
182101;gm. Baligród;leski;Krosno;3277;2696;2672;24
182102;gm. Cisna;leski;Krosno;1745;1508;1419;89
182103;gm. Lesko;leski;Krosno;11190;9247;9176;71
182104;gm. Olszanica;leski;Krosno;4998;4100;4077;23
182105;gm. Solina;leski;Krosno;5451;4560;4450;110
Miasto na prawach powiatu;;;;;;;
186101;m. Krosno;Krosno;Krosno;45042;37451;37299;152
Miasto na prawach powiatu;;;;;;;
186201;m. Przemyśl;Przemyśl;Przemyśl;58095;48770;48074;696
Miasto na prawach powiatu;;;;;;;
186301;m. Rzeszów;Rzeszów;Rzeszów;183050;146418;145540;878
Miasto na prawach powiatu;;;;;;;
186401;m. Tarnobrzeg;Tarnobrzeg;Tarnobrzeg;45298;37992;37740;252
Powiat augustowski;;;;56792;46534;46064;470
200101;m. Augustów;augustowski;Suwałki;28567;23551;23352;199
200102;gm. Augustów;augustowski;Suwałki;6818;5389;5381;8
200103;gm. Bargłów Kościelny;augustowski;Suwałki;5558;4435;4406;29
200104;gm. Lipsk;augustowski;Suwałki;5189;4400;4376;24
200105;gm. Nowinka;augustowski;Suwałki;2957;2402;2283;119
200106;gm. Płaska;augustowski;Suwałki;2582;2126;2060;66
200107;gm. Sztabin;augustowski;Suwałki;5121;4231;4206;25
Powiat białostocki;;;;147028;118649;116572;2077
200201;gm. Choroszcz;białostocki;Białystok;15122;12119;12060;59
200202;gm. Czarna Białostocka;białostocki;Białystok;10978;9003;8942;61
200203;gm. Dobrzyniewo Duże;białostocki;Białystok;9406;7418;7302;116
200204;gm. Gródek;białostocki;Białystok;5252;4409;4241;168
200205;gm. Juchnowiec Kościelny;białostocki;Białystok;16198;12722;12431;291
200206;gm. Łapy;białostocki;Białystok;21260;17730;17548;182
200207;gm. Michałowo;białostocki;Białystok;6568;5524;5264;260
200208;gm. Poświętne;białostocki;Białystok;3461;2818;2790;28
200209;gm. Supraśl;białostocki;Białystok;15406;12342;12052;290
200210;gm. Suraż;białostocki;Białystok;2021;1622;1583;39
200211;gm. Turośń Kościelna;białostocki;Białystok;6408;5119;4936;183
200212;gm. Tykocin;białostocki;Białystok;6267;5121;5055;66
200213;gm. Wasilków;białostocki;Białystok;16716;12972;12789;183
200214;gm. Zabłudów;białostocki;Białystok;9181;7406;7302;104
200215;gm. Zawady;białostocki;Białystok;2784;2324;2277;47
Powiat bielski;;;;55243;45786;44859;927
200301;m. Bielsk Podlaski;bielski;Białystok;24821;20614;20470;144
200302;m. Brańsk;bielski;Białystok;3824;3087;3025;62
200303;gm. Bielsk Podlaski;bielski;Białystok;6927;5838;5484;354
200304;gm. Boćki;bielski;Białystok;4485;3743;3583;160
200305;gm. Brańsk;bielski;Białystok;5931;4842;4803;39
200306;gm. Orla;bielski;Białystok;2868;2463;2329;134
200307;gm. Rudka;bielski;Białystok;1890;1560;1551;9
200308;gm. Wyszki;bielski;Białystok;4497;3639;3614;25
Powiat grajewski;;;;46942;38078;37569;509
200401;m. Grajewo;grajewski;Łomża;21001;17236;16952;284
200402;gm. Grajewo;grajewski;Łomża;5941;4650;4628;22
200403;gm. Radziłów;grajewski;Łomża;4860;3916;3870;46
200404;gm. Rajgród;grajewski;Łomża;5249;4323;4247;76
200405;gm. Szczuczyn;grajewski;Łomża;6179;4986;4920;66
200406;gm. Wąsosz;grajewski;Łomża;3712;2967;2952;15
Powiat hajnowski;;;;42804;36230;35492;738
200501;m. Hajnówka;hajnowski;Białystok;20175;16758;16675;83
200502;gm. Białowieża;hajnowski;Białystok;2183;1912;1783;129
200503;gm. Czeremcha;hajnowski;Białystok;3198;2746;2698;48
200504;gm. Czyże;hajnowski;Białystok;2022;1759;1745;14
200505;gm. Dubicze Cerkiewne;hajnowski;Białystok;1549;1371;1332;39
200506;gm. Hajnówka;hajnowski;Białystok;3967;3354;3242;112
200507;gm. Kleszczele;hajnowski;Białystok;2507;2148;2096;52
200508;gm. Narew;hajnowski;Białystok;3546;3042;2881;161
200509;gm. Narewka;hajnowski;Białystok;3657;3140;3040;100
Powiat kolneński;;;;38404;31147;30934;213
200601;m. Kolno;kolneński;Łomża;9934;8360;8336;24
200602;gm. Grabowo;kolneński;Łomża;3561;2866;2841;25
200603;gm. Kolno;kolneński;Łomża;8704;6853;6815;38
200604;gm. Mały Płock;kolneński;Łomża;4875;3987;3936;51
200605;gm. Stawiski;kolneński;Łomża;6138;5057;5001;56
200606;gm. Turośl;kolneński;Łomża;5192;4024;4005;19
Powiat łomżyński;;;;51332;41274;40791;483
200701;gm. Jedwabne;łomżyński;Łomża;5392;4386;4299;87
200702;gm. Łomża;łomżyński;Łomża;11298;8998;8810;188
200703;gm. Miastkowo;łomżyński;Łomża;4249;3350;3337;13
200704;gm. Nowogród;łomżyński;Łomża;4009;3258;3197;61
200705;gm. Piątnica;łomżyński;Łomża;10542;8468;8420;48
200706;gm. Przytuły;łomżyński;Łomża;2123;1727;1718;9
200707;gm. Śniadowo;łomżyński;Łomża;5448;4341;4320;21
200708;gm. Wizna;łomżyński;Łomża;4066;3325;3285;40
200709;gm. Zbójna;łomżyński;Łomża;4205;3421;3405;16
Powiat moniecki;;;;40545;33606;33104;502
200801;gm. Goniądz;moniecki;Białystok;4945;4057;3982;75
200802;gm. Jasionówka;moniecki;Białystok;2808;2352;2325;27
200803;gm. Jaświły;moniecki;Białystok;5004;4183;4127;56
200804;gm. Knyszyn;moniecki;Białystok;4767;3964;3823;141
200805;gm. Krypno;moniecki;Białystok;3971;3243;3196;47
200806;gm. Mońki;moniecki;Białystok;14622;12173;12060;113
200807;gm. Trzcianne;moniecki;Białystok;4428;3634;3591;43
Powiat sejneński;;;;20099;16650;16436;214
200901;m. Sejny;sejneński;Suwałki;5186;4331;4288;43
200902;gm. Giby;sejneński;Suwałki;2776;2337;2255;82
200903;gm. Krasnopol;sejneński;Suwałki;3857;3130;3080;50
200904;gm. Puńsk;sejneński;Suwałki;4250;3513;3498;15
200905;gm. Sejny;sejneński;Suwałki;4030;3339;3315;24
Powiat siemiatycki;;;;44979;37646;37099;547
201001;m. Siemiatycze;siemiatycki;Białystok;14094;11853;11764;89
201002;gm. Drohiczyn;siemiatycki;Białystok;6360;5328;5268;60
201003;gm. Dziadkowice;siemiatycki;Białystok;2882;2342;2311;31
201004;gm. Grodzisk;siemiatycki;Białystok;4267;3518;3470;48
201005;gm. Mielnik;siemiatycki;Białystok;2465;2142;2017;125
201006;gm. Milejczyce;siemiatycki;Białystok;1888;1605;1522;83
201007;gm. Nurzec-Stacja;siemiatycki;Białystok;4003;3377;3344;33
201008;gm. Perlejewo;siemiatycki;Białystok;2917;2428;2405;23
201009;gm. Siemiatycze;siemiatycki;Białystok;6103;5053;4998;55
Powiat sokólski;;;;67271;55597;54967;630
201101;gm. Dąbrowa Białostocka;sokólski;Suwałki;11444;9662;9619;43
201102;gm. Janów;sokólski;Suwałki;4217;3450;3409;41
201103;gm. Korycin;sokólski;Suwałki;3303;2670;2647;23
201104;gm. Krynki;sokólski;Suwałki;3088;2624;2521;103
201105;gm. Kuźnica;sokólski;Suwałki;4081;3293;3249;44
201106;gm. Nowy Dwór;sokólski;Suwałki;2731;2257;2184;73
201107;gm. Sidra;sokólski;Suwałki;3478;2884;2847;37
201108;gm. Sokółka;sokólski;Suwałki;25035;20519;20364;155
201109;gm. Suchowola;sokólski;Suwałki;6936;5754;5697;57
201110;gm. Szudziałowo;sokólski;Suwałki;2958;2484;2430;54
Powiat suwalski;;;;36445;29158;28469;689
201201;gm. Bakałarzewo;suwalski;Suwałki;3210;2554;2524;30
201202;gm. Filipów;suwalski;Suwałki;4403;3550;3364;186
201203;gm. Jeleniewo;suwalski;Suwałki;3205;2539;2485;54
201204;gm. Przerośl;suwalski;Suwałki;3015;2421;2365;56
201205;gm. Raczki;suwalski;Suwałki;5971;4740;4708;32
201206;gm. Rutka-Tartak;suwalski;Suwałki;2447;1950;1926;24
201207;gm. Suwałki;suwalski;Suwałki;7746;6202;5995;207
201208;gm. Szypliszki;suwalski;Suwałki;4011;3242;3172;70
201209;gm. Wiżajny;suwalski;Suwałki;2437;1960;1930;30
Powiat wysokomazowiecki;;;;57562;46609;46261;348
201301;m. Wysokie Mazowieckie;wysokomazowiecki;Łomża;9256;7464;7397;67
201302;gm. Ciechanowiec;wysokomazowiecki;Łomża;8663;7218;7118;100
201303;gm. Czyżew;wysokomazowiecki;Łomża;6500;5190;5165;25
201304;gm. Klukowo;wysokomazowiecki;Łomża;4458;3611;3599;12
201305;gm. Kobylin-Borzymy;wysokomazowiecki;Łomża;3294;2742;2734;8
201306;gm. Kulesze Kościelne;wysokomazowiecki;Łomża;3129;2509;2488;21
201307;gm. Nowe Piekuty;wysokomazowiecki;Łomża;3954;3199;3168;31
201308;gm. Sokoły;wysokomazowiecki;Łomża;5798;4670;4643;27
201309;gm. Szepietowo;wysokomazowiecki;Łomża;7012;5685;5652;33
201310;gm. Wysokie Mazowieckie;wysokomazowiecki;Łomża;5498;4321;4297;24
Powiat zambrowski;;;;42927;34960;34671;289
201401;m. Zambrów;zambrowski;Łomża;21214;17538;17443;95
201402;gm. Kołaki Kościelne;zambrowski;Łomża;2377;1953;1906;47
201403;gm. Rutki;zambrowski;Łomża;5604;4527;4484;43
201404;gm. Szumowo;zambrowski;Łomża;4921;3911;3834;77
201405;gm. Zambrów;zambrowski;Łomża;8811;7031;7004;27
Miasto na prawach powiatu;;;;;;;
206101;m. Białystok;Białystok;Białystok;273165;220457;219256;1201
Miasto na prawach powiatu;;;;;;;
206201;m. Łomża;Łomża;Łomża;58708;48210;47937;273
Miasto na prawach powiatu;;;;;;;
206301;m. Suwałki;Suwałki;Suwałki;66705;53515;53164;351
Powiat bytowski;;;;77715;60862;60317;545
220101;gm. Borzytuchom;bytowski;Słupsk;3330;2498;2480;18
220102;gm. Bytów;bytowski;Słupsk;24429;19156;19067;89
220103;gm. Czarna Dąbrówka;bytowski;Słupsk;5973;4544;4487;57
220104;gm. Kołczygłowy;bytowski;Słupsk;4305;3378;3329;49
220105;gm. Lipnica;bytowski;Słupsk;5291;4158;4100;58
220106;gm. Miastko;bytowski;Słupsk;18912;15249;15140;109
220107;gm. Parchowo;bytowski;Słupsk;3870;2855;2806;49
220108;gm. Studzienice;bytowski;Słupsk;3697;2845;2802;43
220109;gm. Trzebielino;bytowski;Słupsk;3688;2883;2835;48
220110;gm. Tuchomie;bytowski;Słupsk;4220;3296;3271;25
Powiat chojnicki;;;;94389;74135;73754;381
220201;m. Chojnice;chojnicki;Słupsk;37752;30686;30546;140
220202;gm. Brusy;chojnicki;Słupsk;14428;10855;10769;86
220203;gm. Chojnice;chojnicki;Słupsk;18810;14343;14261;82
220204;gm. Czersk;chojnicki;Słupsk;21048;16470;16410;60
220205;gm. Konarzyny;chojnicki;Słupsk;2351;1781;1768;13
Powiat człuchowski;;;;54714;43881;43478;403
220301;m. Człuchów;człuchowski;Słupsk;13084;10946;10865;81
220302;gm. Czarne;człuchowski;Słupsk;8765;6985;6950;35
220303;gm. Człuchów;człuchowski;Słupsk;10833;8417;8372;45
220304;gm. Debrzno;człuchowski;Słupsk;8862;7092;7033;59
220305;gm. Koczała;człuchowski;Słupsk;3306;2665;2609;56
220306;gm. Przechlewo;człuchowski;Słupsk;6235;4859;4804;55
220307;gm. Rzeczenica;człuchowski;Słupsk;3629;2917;2845;72
Powiat gdański;;;;111896;85582;83797;1785
220401;m. Pruszcz Gdański;gdański;Gdańsk;28543;22192;21931;261
220402;gm. Cedry Wielkie;gdański;Gdańsk;6680;5204;5155;49
220403;gm. Kolbudy;gdański;Gdańsk;17129;13144;12580;564
220404;gm. Pruszcz Gdański;gdański;Gdańsk;29400;21758;21228;530
220405;gm. Przywidz;gdański;Gdańsk;5786;4496;4406;90
220406;gm. Pszczółki;gdański;Gdańsk;9386;7222;7170;52
220407;gm. Suchy Dąb;gdański;Gdańsk;4139;3263;3163;100
220408;gm. Trąbki Wielkie;gdański;Gdańsk;10833;8303;8164;139
Powiat kartuski;;;;134936;98902;97601;1301
220501;gm. Chmielno;kartuski;Słupsk;7847;5723;5678;45
220502;gm. Kartuzy;kartuski;Słupsk;32263;24588;24365;223
220503;gm. Przodkowo;kartuski;Słupsk;9464;6756;6681;75
220504;gm. Sierakowice;kartuski;Słupsk;19712;13831;13762;69
220505;gm. Somonino;kartuski;Słupsk;10751;7888;7801;87
220506;gm. Stężyca;kartuski;Słupsk;10574;7477;7438;39
220507;gm. Sulęczyno;kartuski;Słupsk;5576;4112;4016;96
220508;gm. Żukowo;kartuski;Słupsk;38749;28527;27860;667
Powiat kościerski;;;;70870;54489;53892;597
220601;m. Kościerzyna;kościerski;Słupsk;22334;17681;17503;178
220602;gm. Dziemiany;kościerski;Słupsk;4457;3370;3316;54
220603;gm. Karsin;kościerski;Słupsk;6253;4823;4755;68
220604;gm. Kościerzyna;kościerski;Słupsk;15635;11792;11689;103
220605;gm. Liniewo;kościerski;Słupsk;4603;3557;3477;80
220606;gm. Lipusz;kościerski;Słupsk;3741;2812;2793;19
220607;gm. Nowa Karczma;kościerski;Słupsk;6992;5196;5163;33
220608;gm. Stara Kiszewa;kościerski;Słupsk;6855;5258;5196;62
Powiat kwidzyński;;;;79660;62874;62572;302
220701;m. Kwidzyn;kwidzyński;Gdańsk;35761;28707;28575;132
220702;gm. Gardeja;kwidzyński;Gdańsk;8385;6435;6412;23
220703;gm. Kwidzyn;kwidzyński;Gdańsk;11198;8638;8580;58
220704;gm. Prabuty;kwidzyński;Gdańsk;12725;10141;10081;60
220705;gm. Ryjewo;kwidzyński;Gdańsk;5672;4356;4350;6
220706;gm. Sadlinki;kwidzyński;Gdańsk;5919;4597;4574;23
Powiat lęborski;;;;62870;49780;49220;560
220801;m. Lębork;lęborski;Słupsk;33033;26536;26356;180
220802;m. Łeba;lęborski;Słupsk;3553;3005;2830;175
220803;gm. Cewice;lęborski;Słupsk;7125;5366;5256;110
220804;gm. Nowa Wieś Lęborska;lęborski;Słupsk;13339;10310;10264;46
220805;gm. Wicko;lęborski;Słupsk;5820;4563;4514;49
Powiat malborski;;;;60547;49025;48523;502
220901;m. Malbork;malborski;Gdańsk;36270;29730;29498;232
220903;gm. Lichnowy;malborski;Gdańsk;4475;3500;3472;28
220904;gm. Malbork;malborski;Gdańsk;4668;3725;3610;115
220906;gm. Miłoradz;malborski;Gdańsk;3362;2672;2626;46
220907;gm. Nowy Staw;malborski;Gdańsk;7196;5788;5737;51
220908;gm. Stare Pole;malborski;Gdańsk;4576;3610;3580;30
Powiat nowodworski;;;;34762;28038;27687;351
221001;m. Krynica Morska;nowodworski;Gdańsk;1339;1136;1013;123
221002;gm. Nowy Dwór Gdański;nowodworski;Gdańsk;17019;13711;13647;64
221003;gm. Ostaszewo;nowodworski;Gdańsk;3152;2494;2464;30
221004;gm. Stegna;nowodworski;Gdańsk;9626;7757;7670;87
221005;gm. Sztutowo;nowodworski;Gdańsk;3626;2940;2893;47
Powiat pucki;;;;84457;65276;64105;1171
221101;m. Hel;pucki;Słupsk;3198;2639;2519;120
221102;gm. Jastarnia;pucki;Słupsk;3611;2957;2930;27
221103;m. Puck;pucki;Słupsk;10646;8581;8456;125
221104;gm. Władysławowo;pucki;Słupsk;14936;11842;11690;152
221105;gm. Kosakowo;pucki;Słupsk;15187;11382;10877;505
221106;gm. Krokowa;pucki;Słupsk;10761;8225;8138;87
221107;gm. Puck;pucki;Słupsk;26118;19650;19495;155
Powiat słupski;;;;94004;74872;74119;753
221201;m. Ustka;słupski;Słupsk;14355;12070;11983;87
221202;gm. Damnica;słupski;Słupsk;5852;4662;4605;57
221203;gm. Dębnica Kaszubska;słupski;Słupsk;9318;7417;7321;96
221204;gm. Główczyce;słupski;Słupsk;8912;6961;6935;26
221205;gm. Kępice;słupski;Słupsk;8694;7019;6976;43
221206;gm. Kobylnica;słupski;Słupsk;12027;9353;9240;113
221207;gm. Potęgowo;słupski;Słupsk;6759;5276;5246;30
221208;gm. Słupsk;słupski;Słupsk;16903;13116;13057;59
221209;gm. Smołdzino;słupski;Słupsk;3188;2646;2587;59
221210;gm. Ustka;słupski;Słupsk;7996;6352;6169;183
Powiat starogardzki;;;;122695;96073;95274;799
221301;gm. Czarna Woda;starogardzki;Gdańsk;3150;2587;2572;15
221302;m. Skórcz;starogardzki;Gdańsk;3442;2704;2676;28
221303;m. Starogard Gdański;starogardzki;Gdańsk;44193;35419;35247;172
221304;gm. Bobowo;starogardzki;Gdańsk;3150;2370;2357;13
221305;gm. Kaliska;starogardzki;Gdańsk;5379;4212;4144;68
221306;gm. Lubichowo;starogardzki;Gdańsk;6491;4999;4938;61
221307;gm. Osieczna;starogardzki;Gdańsk;2881;2264;2257;7
221308;gm. Osiek;starogardzki;Gdańsk;2425;1982;1937;45
221309;gm. Skarszewy;starogardzki;Gdańsk;14063;10853;10701;152
221310;gm. Skórcz;starogardzki;Gdańsk;4563;3514;3495;19
221311;gm. Smętowo Graniczne;starogardzki;Gdańsk;5150;4062;4037;25
221312;gm. Starogard Gdański;starogardzki;Gdańsk;16159;12198;12095;103
221313;gm. Zblewo;starogardzki;Gdańsk;11649;8909;8818;91
Powiat tczewski;;;;109698;86816;86104;712
221401;m. Tczew;tczewski;Gdańsk;55205;44540;44262;278
221402;gm. Gniew;tczewski;Gdańsk;15018;11906;11836;70
221403;gm. Morzeszczyn;tczewski;Gdańsk;3609;2793;2782;11
221404;gm. Pelplin;tczewski;Gdańsk;15944;12419;12277;142
221405;gm. Subkowy;tczewski;Gdańsk;5387;4180;4151;29
221406;gm. Tczew;tczewski;Gdańsk;14535;10978;10796;182
Powiat wejherowski;;;;205492;157591;155812;1779
221501;m. Reda;wejherowski;Słupsk;24361;18564;18360;204
221502;m. Rumia;wejherowski;Słupsk;46129;36855;36514;341
221503;m. Wejherowo;wejherowski;Słupsk;44807;35555;35220;335
221504;gm. Choczewo;wejherowski;Słupsk;5478;4378;4253;125
221505;gm. Gniewino;wejherowski;Słupsk;7217;5457;5382;75
221506;gm. Linia;wejherowski;Słupsk;6400;4707;4670;37
221507;gm. Luzino;wejherowski;Słupsk;15911;11573;11508;65
221508;gm. Łęczyce;wejherowski;Słupsk;11872;8844;8786;58
221509;gm. Szemud;wejherowski;Słupsk;17966;13072;12764;308
221510;gm. Wejherowo;wejherowski;Słupsk;25351;18586;18355;231
Powiat sztumski;;;;40406;32341;32147;194
221601;gm. Dzierzgoń;sztumski;Gdańsk;9265;7492;7463;29
221602;gm. Mikołajki Pomorskie;sztumski;Gdańsk;3507;2782;2759;23
221603;gm. Stary Dzierzgoń;sztumski;Gdańsk;4024;3200;3165;35
221604;gm. Stary Targ;sztumski;Gdańsk;6188;4876;4858;18
221605;gm. Sztum;sztumski;Gdańsk;17422;13991;13902;89
Miasto na prawach powiatu;;;;;;;
226101;m. Gdańsk;Gdańsk;Gdańsk;425773;347605;342940;4665
Miasto na prawach powiatu;;;;;;;
226201;m. Gdynia;Gdynia;Słupsk;225774;186808;184716;2092
Miasto na prawach powiatu;;;;;;;
226301;m. Słupsk;Słupsk;Słupsk;84293;70765;70440;325
Miasto na prawach powiatu;;;;;;;
226401;m. Sopot;Sopot;Gdańsk;32888;27863;27198;665
Powiat będziński;;;;141144;117933;116853;1080
240101;m. Będzin;będziński;Katowice;52325;43700;43451;249
240102;m. Czeladź;będziński;Katowice;29898;25298;25057;241
240103;m. Wojkowice;będziński;Katowice;8541;7243;7186;57
240104;gm. Bobrowniki;będziński;Katowice;11912;9874;9771;103
240105;gm. Mierzęcice;będziński;Katowice;7423;6174;6095;79
240106;gm. Psary;będziński;Katowice;11964;9872;9777;95
240107;gm. Siewierz;będziński;Katowice;12233;10129;9989;140
240108;m. Sławków;będziński;Katowice;6848;5643;5527;116
Powiat bielski;;;;161579;128807;127880;927
240201;m. Szczyrk;bielski;Bielsko-Biała;5690;4621;4533;88
240202;gm. Bestwina;bielski;Bielsko-Biała;11823;9319;9294;25
240203;gm. Buczkowice;bielski;Bielsko-Biała;10957;8772;8723;49
240204;gm. Czechowice-Dziedzice;bielski;Bielsko-Biała;43461;34931;34686;245
240205;gm. Jasienica;bielski;Bielsko-Biała;24101;18663;18576;87
240206;gm. Jaworze;bielski;Bielsko-Biała;6983;5715;5606;109
240207;gm. Kozy;bielski;Bielsko-Biała;12790;10154;10082;72
240208;gm. Porąbka;bielski;Bielsko-Biała;15464;12403;12338;65
240209;gm. Wilamowice;bielski;Bielsko-Biała;17461;13656;13603;53
240210;gm. Wilkowice;bielski;Bielsko-Biała;12849;10573;10439;134
Powiat cieszyński;;;;171911;138071;136593;1478
240301;m. Cieszyn;cieszyński;Bielsko-Biała;31899;26333;25876;457
240302;m. Ustroń;cieszyński;Bielsko-Biała;15277;12854;12673;181
240303;m. Wisła;cieszyński;Bielsko-Biała;10968;8997;8867;130
240304;gm. Brenna;cieszyński;Bielsko-Biała;11206;8829;8666;163
240305;gm. Chybie;cieszyński;Bielsko-Biała;9639;7547;7536;11
240306;gm. Dębowiec;cieszyński;Bielsko-Biała;5742;4533;4504;29
240307;gm. Goleszów;cieszyński;Bielsko-Biała;12822;10390;10328;62
240308;gm. Hażlach;cieszyński;Bielsko-Biała;10521;8308;8263;45
240309;gm. Istebna;cieszyński;Bielsko-Biała;12232;9245;9165;80
240310;gm. Skoczów;cieszyński;Bielsko-Biała;25680;20526;20313;213
240311;gm. Strumień;cieszyński;Bielsko-Biała;13109;10268;10210;58
240312;gm. Zebrzydowice;cieszyński;Bielsko-Biała;12816;10241;10192;49
Powiat częstochowski;;;;134090;110518;109081;1437
240401;gm. Blachownia;częstochowski;Częstochowa;12602;10483;10367;116
240402;gm. Dąbrowa Zielona;częstochowski;Częstochowa;3957;3359;3253;106
240403;gm. Janów;częstochowski;Częstochowa;6027;4957;4838;119
240404;gm. Kamienica Polska;częstochowski;Częstochowa;5469;4549;4491;58
240405;gm. Kłomnice;częstochowski;Częstochowa;13379;11198;11109;89
240406;gm. Koniecpol;częstochowski;Częstochowa;9451;7974;7925;49
240407;gm. Konopiska;częstochowski;Częstochowa;10647;8720;8604;116
240408;gm. Kruszyna;częstochowski;Częstochowa;4815;3987;3909;78
240409;gm. Lelów;częstochowski;Częstochowa;4877;4052;3969;83
240410;gm. Mstów;częstochowski;Częstochowa;10915;8862;8697;165
240411;gm. Mykanów;częstochowski;Częstochowa;14932;12033;11972;61
240412;gm. Olsztyn;częstochowski;Częstochowa;8130;6572;6461;111
240413;gm. Poczesna;częstochowski;Częstochowa;12579;10356;10263;93
240414;gm. Przyrów;częstochowski;Częstochowa;3726;3100;3057;43
240415;gm. Rędziny;częstochowski;Częstochowa;9755;8013;7923;90
240416;gm. Starcza;częstochowski;Częstochowa;2829;2303;2243;60
Powiat gliwicki;;;;109834;89114;88658;456
240501;m. Knurów;gliwicki;Katowice;35910;28928;28868;60
240502;m. Pyskowice;gliwicki;Katowice;16622;13824;13761;63
240503;gm. Gierałtowice;gliwicki;Katowice;11864;9416;9371;45
240504;gm. Pilchowice;gliwicki;Katowice;11629;9222;9142;80
240505;gm. Rudziniec;gliwicki;Katowice;10426;8572;8477;95
240506;gm. Sośnicowice;gliwicki;Katowice;8552;6885;6829;56
240507;gm. Toszek;gliwicki;Katowice;9031;7470;7425;45
240508;gm. Wielowieś;gliwicki;Katowice;5800;4797;4785;12
Powiat kłobucki;;;;84423;69438;68998;440
240601;gm. Kłobuck;kłobucki;Częstochowa;20073;16656;16507;149
240602;gm. Krzepice;kłobucki;Częstochowa;9112;7575;7547;28
240603;gm. Lipie;kłobucki;Częstochowa;6224;5186;5166;20
240604;gm. Miedźno;kłobucki;Częstochowa;7621;6175;6138;37
240605;gm. Opatów;kłobucki;Częstochowa;6819;5540;5515;25
240606;gm. Panki;kłobucki;Częstochowa;5041;4102;4077;25
240607;gm. Popów;kłobucki;Częstochowa;5945;4889;4840;49
240608;gm. Przystajń;kłobucki;Częstochowa;5910;4826;4801;25
240609;gm. Wręczyca Wielka;kłobucki;Częstochowa;17678;14489;14407;82
Powiat lubliniecki;;;;74455;60666;60330;336
240701;m. Lubliniec;lubliniecki;Częstochowa;22286;18283;18187;96
240702;gm. Boronów;lubliniecki;Częstochowa;3378;2757;2728;29
240703;gm. Ciasna;lubliniecki;Częstochowa;7462;6169;6151;18
240704;gm. Herby;lubliniecki;Częstochowa;6597;5368;5345;23
240705;gm. Kochanowice;lubliniecki;Częstochowa;6913;5567;5543;24
240706;gm. Koszęcin;lubliniecki;Częstochowa;11704;9447;9381;66
240707;gm. Pawonków;lubliniecki;Częstochowa;6546;5307;5285;22
240708;gm. Woźniki;lubliniecki;Częstochowa;9569;7768;7710;58
Powiat mikołowski;;;;94891;75633;75074;559
240801;m. Łaziska Górne;mikołowski;Bielsko-Biała;20712;16810;16607;203
240802;m. Mikołów;mikołowski;Bielsko-Biała;39433;31701;31520;181
240803;m. Orzesze;mikołowski;Bielsko-Biała;20612;16156;16054;102
240804;gm. Ornontowice;mikołowski;Bielsko-Biała;5953;4671;4633;38
240805;gm. Wyry;mikołowski;Bielsko-Biała;8181;6295;6260;35
Powiat myszkowski;;;;70005;57810;56807;1003
240901;m. Myszków;myszkowski;Częstochowa;30572;25361;25129;232
240902;gm. Koziegłowy;myszkowski;Częstochowa;14549;11918;11704;214
240903;gm. Niegowa;myszkowski;Częstochowa;5714;4613;4489;124
240904;gm. Poraj;myszkowski;Częstochowa;10719;9004;8857;147
240905;gm. Żarki;myszkowski;Częstochowa;8451;6914;6628;286
Powiat pszczyński;;;;107672;84688;84287;401
241001;gm. Goczałkowice-Zdrój;pszczyński;Bielsko-Biała;6678;5394;5370;24
241002;gm. Kobiór;pszczyński;Bielsko-Biała;4795;3871;3836;35
241003;gm. Miedźna;pszczyński;Bielsko-Biała;15577;12261;12192;69
241004;gm. Pawłowice;pszczyński;Bielsko-Biała;17546;13677;13617;60
241005;gm. Pszczyna;pszczyński;Bielsko-Biała;50934;40193;40025;168
241006;gm. Suszec;pszczyński;Bielsko-Biała;12142;9292;9247;45
Powiat raciborski;;;;100983;83924;83659;265
241101;m. Racibórz;raciborski;Bielsko-Biała;49696;41567;41436;131
241102;gm. Kornowac;raciborski;Bielsko-Biała;5084;4036;4030;6
241103;gm. Krzanowice;raciborski;Bielsko-Biała;5573;4652;4646;6
241104;gm. Krzyżanowice;raciborski;Bielsko-Biała;11047;9028;9008;20
241105;gm. Kuźnia Raciborska;raciborski;Bielsko-Biała;11068;9267;9232;35
241106;gm. Nędza;raciborski;Bielsko-Biała;6949;5795;5766;29
241107;gm. Pietrowice Wielkie;raciborski;Bielsko-Biała;6564;5455;5437;18
241108;gm. Rudnik;raciborski;Bielsko-Biała;5002;4124;4104;20
Powiat rybnicki;;;;75459;60217;59966;251
241201;gm. Czerwionka-Leszczyny;rybnicki;Bielsko-Biała;40105;32255;32109;146
241202;gm. Gaszowice;rybnicki;Bielsko-Biała;9568;7546;7514;32
241203;gm. Jejkowice;rybnicki;Bielsko-Biała;4107;3198;3193;5
241204;gm. Lyski;rybnicki;Bielsko-Biała;9507;7757;7708;49
241205;gm. Świerklany;rybnicki;Bielsko-Biała;12172;9461;9442;19
Powiat tarnogórski;;;;133324;109754;109069;685
241301;m. Kalety;tarnogórski;Katowice;8420;7088;7059;29
241302;m. Miasteczko Śląskie;tarnogórski;Katowice;6981;5754;5704;50
241303;m. Radzionków;tarnogórski;Katowice;15985;13215;13146;69
241304;m. Tarnowskie Góry;tarnogórski;Katowice;57872;47565;47396;169
241305;gm. Krupski Młyn;tarnogórski;Katowice;3141;2667;2579;88
241306;gm. Ożarowice;tarnogórski;Katowice;5723;4683;4653;30
241307;gm. Świerklaniec;tarnogórski;Katowice;12093;9751;9695;56
241308;gm. Tworóg;tarnogórski;Katowice;7962;6594;6520;74
241309;gm. Zbrosławice;tarnogórski;Katowice;15147;12437;12317;120
Powiat bieruńsko-lędziński;;;;57791;46202;45816;386
241401;m. Bieruń;bieruńsko-lędziński;Katowice;18991;15298;15162;136
241402;m. Imielin;bieruńsko-lędziński;Katowice;8913;7086;7021;65
241403;m. Lędziny;bieruńsko-lędziński;Katowice;15974;12791;12690;101
241404;gm. Bojszowy;bieruńsko-lędziński;Katowice;7844;6119;6082;37
241405;gm. Chełm Śląski;bieruńsko-lędziński;Katowice;6069;4908;4861;47
Powiat wodzisławski;;;;150145;121728;121140;588
241501;m. Pszów;wodzisławski;Bielsko-Biała;13151;10826;10761;65
241502;m. Radlin;wodzisławski;Bielsko-Biała;16971;13730;13662;68
241503;m. Rydułtowy;wodzisławski;Bielsko-Biała;20005;16404;16299;105
241504;m. Wodzisław Śląski;wodzisławski;Bielsko-Biała;45003;36968;36768;200
241505;gm. Godów;wodzisławski;Bielsko-Biała;13558;10862;10837;25
241506;gm. Gorzyce;wodzisławski;Bielsko-Biała;20744;16448;16379;69
241507;gm. Lubomia;wodzisławski;Bielsko-Biała;7749;6263;6254;9
241508;gm. Marklowice;wodzisławski;Bielsko-Biała;5362;4268;4241;27
241509;gm. Mszana;wodzisławski;Bielsko-Biała;7602;5959;5939;20
Powiat zawierciański;;;;115325;96393;95603;790
241601;m. Poręba;zawierciański;Katowice;8276;6950;6889;61
241602;m. Zawiercie;zawierciański;Katowice;47430;39914;39733;181
241603;gm. Irządze;zawierciański;Katowice;2632;2207;2164;43
241604;gm. Kroczyce;zawierciański;Katowice;6329;5206;5112;94
241605;gm. Łazy;zawierciański;Katowice;15444;12853;12761;92
241606;gm. Ogrodzieniec;zawierciański;Katowice;9092;7562;7477;85
241607;gm. Pilica;zawierciański;Katowice;8539;7126;7027;99
241608;gm. Szczekociny;zawierciański;Katowice;7666;6487;6425;62
241609;gm. Włodowice;zawierciański;Katowice;5236;4318;4295;23
241610;gm. Żarnowiec;zawierciański;Katowice;4681;3770;3720;50
Powiat żywiecki;;;;150882;121824;120810;1014
241701;m. Żywiec;żywiecki;Bielsko-Biała;30211;24846;24741;105
241702;gm. Czernichów;żywiecki;Bielsko-Biała;6452;5303;5203;100
241703;gm. Gilowice;żywiecki;Bielsko-Biała;6193;4883;4855;28
241704;gm. Jeleśnia;żywiecki;Bielsko-Biała;13291;10789;10686;103
241705;gm. Koszarawa;żywiecki;Bielsko-Biała;2469;2026;1932;94
241706;gm. Lipowa;żywiecki;Bielsko-Biała;10566;8451;8394;57
241707;gm. Łękawica;żywiecki;Bielsko-Biała;4503;3608;3560;48
241708;gm. Łodygowice;żywiecki;Bielsko-Biała;14548;11496;11452;44
241709;gm. Milówka;żywiecki;Bielsko-Biała;9981;8031;7965;66
241710;gm. Radziechowy-Wieprz;żywiecki;Bielsko-Biała;13051;10367;10324;43
241711;gm. Rajcza;żywiecki;Bielsko-Biała;8621;7061;7004;57
241712;gm. Ślemień;żywiecki;Bielsko-Biała;3557;2884;2827;57
241713;gm. Świnna;żywiecki;Bielsko-Biała;7991;6526;6428;98
241714;gm. Ujsoły;żywiecki;Bielsko-Biała;4434;3651;3602;49
241715;gm. Węgierska Górka;żywiecki;Bielsko-Biała;15014;11902;11837;65
Miasto na prawach powiatu;;;;;;;
246101;m. Bielsko-Biała;Bielsko-Biała;Bielsko-Biała;160844;132647;131334;1313
Miasto na prawach powiatu;;;;;;;
246201;m. Bytom;Bytom;Katowice;143816;119692;119263;429
Miasto na prawach powiatu;;;;;;;
246301;m. Chorzów;Chorzów;Katowice;97151;80212;79600;612
Miasto na prawach powiatu;;;;;;;
246401;m. Częstochowa;Częstochowa;Częstochowa;208283;175618;174414;1204
Miasto na prawach powiatu;;;;;;;
246501;m. Dąbrowa Górnicza;Dąbrowa Górnicza;Katowice;113420;95122;94723;399
Miasto na prawach powiatu;;;;;;;
246601;m. Gliwice;Gliwice;Katowice;165852;137884;136870;1014
Miasto na prawach powiatu;;;;;;;
246701;m. Jastrzębie-Zdrój;Jastrzębie-Zdrój;Bielsko-Biała;83192;68538;68389;149
Miasto na prawach powiatu;;;;;;;
246801;m. Jaworzno;Jaworzno;Katowice;86528;71881;71589;292
Miasto na prawach powiatu;;;;;;;
246901;m. Katowice;Katowice;Katowice;267391;225597;224741;856
Miasto na prawach powiatu;;;;;;;
247001;m. Mysłowice;Mysłowice;Katowice;69089;56347;55991;356
Miasto na prawach powiatu;;;;;;;
247101;m. Piekary Śląskie;Piekary Śląskie;Katowice;51486;42666;42609;57
Miasto na prawach powiatu;;;;;;;
247201;m. Ruda Śląska;Ruda Śląska;Katowice;129131;105777;105577;200
Miasto na prawach powiatu;;;;;;;
247301;m. Rybnik;Rybnik;Bielsko-Biała;129062;105079;104738;341
Miasto na prawach powiatu;;;;;;;
247401;m. Siemianowice Śląskie;Siemianowice Śląskie;Katowice;61575;51134;50932;202
Miasto na prawach powiatu;;;;;;;
247501;m. Sosnowiec;Sosnowiec;Katowice;186769;159348;158619;729
Miasto na prawach powiatu;;;;;;;
247601;m. Świętochłowice;Świętochłowice;Katowice;45369;37496;37379;117
Miasto na prawach powiatu;;;;;;;
247701;m. Tychy;Tychy;Katowice;120162;98053;97585;468
Miasto na prawach powiatu;;;;;;;
247801;m. Zabrze;Zabrze;Katowice;154511;128443;128137;306
Miasto na prawach powiatu;;;;;;;
247901;m. Żory;Żory;Bielsko-Biała;58417;46787;46605;182
Powiat buski;;;;71037;59089;58312;777
260101;gm. Busko-Zdrój;buski;Kielce;31164;26089;25952;137
260102;gm. Gnojno;buski;Kielce;4492;3670;3612;58
260103;gm. Nowy Korczyn;buski;Kielce;5995;5029;4907;122
260104;gm. Pacanów;buski;Kielce;7466;6210;6014;196
260105;gm. Solec-Zdrój;buski;Kielce;5057;4126;4053;73
260106;gm. Stopnica;buski;Kielce;7627;6282;6184;98
260107;gm. Tuczępy;buski;Kielce;3753;3078;3049;29
260108;gm. Wiślica;buski;Kielce;5483;4605;4541;64
Powiat jędrzejowski;;;;85666;70064;69323;741
260201;gm. Imielno;jędrzejowski;Kielce;4430;3590;3535;55
260202;gm. Jędrzejów;jędrzejowski;Kielce;27549;22660;22622;38
260203;gm. Małogoszcz;jędrzejowski;Kielce;11599;9351;9283;68
260204;gm. Nagłowice;jędrzejowski;Kielce;4929;4008;3942;66
260205;gm. Oksa;jędrzejowski;Kielce;4673;3821;3720;101
260206;gm. Sędziszów;jędrzejowski;Kielce;12560;10303;10154;149
260207;gm. Słupia (Jędrzejowska);jędrzejowski;Kielce;4321;3553;3501;52
260208;gm. Sobków;jędrzejowski;Kielce;8530;6882;6791;91
260209;gm. Wodzisław;jędrzejowski;Kielce;7075;5896;5775;121
Powiat kazimierski;;;;33557;28393;27996;397
260301;gm. Bejsce;kazimierski;Kielce;3998;3386;3333;53
260302;gm. Czarnocin;kazimierski;Kielce;3843;3258;3223;35
260303;gm. Kazimierza Wielka;kazimierski;Kielce;15724;13354;13197;157
260304;gm. Opatowiec;kazimierski;Kielce;3478;3009;2889;120
260305;gm. Skalbmierz;kazimierski;Kielce;6514;5386;5354;32
Powiat kielecki;;;;210021;169082;166989;2093
260401;gm. Bieliny;kielecki;Kielce;10315;8113;8073;40
260402;gm. Bodzentyn;kielecki;Kielce;11475;9351;9254;97
260403;gm. Chęciny;kielecki;Kielce;14897;12134;12045;89
260404;gm. Chmielnik;kielecki;Kielce;11180;9058;8967;91
260405;gm. Daleszyce;kielecki;Kielce;15876;12775;12568;207
260406;gm. Górno;kielecki;Kielce;14515;11386;11265;121
260407;gm. Łagów;kielecki;Kielce;6937;5588;5514;74
260408;gm. Łopuszno;kielecki;Kielce;9107;7339;7218;121
260409;gm. Masłów;kielecki;Kielce;10868;8803;8698;105
260410;gm. Miedziana Góra;kielecki;Kielce;11513;9244;9149;95
260411;gm. Mniów;kielecki;Kielce;9410;7569;7513;56
260412;gm. Morawica;kielecki;Kielce;16372;12834;12759;75
260413;gm. Nowa Słupia;kielecki;Kielce;9699;8009;7760;249
260414;gm. Piekoszów;kielecki;Kielce;16337;13189;13044;145
260415;gm. Pierzchnica;kielecki;Kielce;4718;3801;3692;109
260416;gm. Raków;kielecki;Kielce;5632;4674;4608;66
260417;gm. Nowiny;kielecki;Kielce;7595;6067;5885;182
260418;gm. Strawczyn;kielecki;Kielce;10857;8537;8482;55
260419;gm. Zagnańsk;kielecki;Kielce;12718;10611;10495;116
Powiat konecki;;;;79765;66795;66166;629
260501;gm. Fałków;konecki;Kielce;4460;3736;3662;74
260502;gm. Gowarczów;konecki;Kielce;4687;3854;3799;55
260503;gm. Końskie;konecki;Kielce;34646;29165;29063;102
260504;gm. Radoszyce;konecki;Kielce;8999;7338;7252;86
260505;gm. Ruda Maleniecka;konecki;Kielce;3099;2608;2517;91
260506;gm. Słupia Konecka;konecki;Kielce;3341;2723;2668;55
260507;gm. Smyków;konecki;Kielce;3845;3058;3040;18
260508;gm. Stąporków;konecki;Kielce;16688;14313;14165;148
Powiat opatowski;;;;52580;43654;42961;693
260601;gm. Baćkowice;opatowski;Kielce;4886;4023;3982;41
260602;gm. Iwaniska;opatowski;Kielce;6740;5496;5443;53
260603;gm. Lipnik;opatowski;Kielce;5357;4429;4386;43
260604;gm. Opatów;opatowski;Kielce;11557;9746;9647;99
260605;gm. Ożarów;opatowski;Kielce;10749;8786;8607;179
260606;gm. Sadowie;opatowski;Kielce;3972;3304;3248;56
260607;gm. Tarłów;opatowski;Kielce;5256;4465;4332;133
260608;gm. Wojciechowice;opatowski;Kielce;4063;3405;3316;89
Powiat ostrowiecki;;;;105856;89429;88768;661
260701;m. Ostrowiec Świętokrzyski;ostrowiecki;Kielce;65271;55664;55377;287
260702;gm. Bałtów;ostrowiecki;Kielce;3572;3015;2951;64
260703;gm. Bodzechów;ostrowiecki;Kielce;13272;11110;11062;48
260704;gm. Ćmielów;ostrowiecki;Kielce;7236;6069;5957;112
260705;gm. Kunów;ostrowiecki;Kielce;9737;8064;7956;108
260706;gm. Waśniów;ostrowiecki;Kielce;6768;5507;5465;42
Powiat pińczowski;;;;39105;32739;32245;494
260801;gm. Działoszyce;pińczowski;Kielce;5004;4222;4155;67
260802;gm. Kije;pińczowski;Kielce;4454;3720;3651;69
260803;gm. Michałów;pińczowski;Kielce;4679;3816;3694;122
260804;gm. Pińczów;pińczowski;Kielce;20428;17143;16975;168
260805;gm. Złota;pińczowski;Kielce;4540;3838;3770;68
Powiat sandomierski;;;;77022;64367;63683;684
260901;m. Sandomierz;sandomierski;Kielce;22777;19360;19189;171
260902;gm. Dwikozy;sandomierski;Kielce;8745;7272;7249;23
260903;gm. Klimontów;sandomierski;Kielce;8151;6700;6620;80
260904;gm. Koprzywnica;sandomierski;Kielce;6733;5604;5529;75
260905;gm. Łoniów;sandomierski;Kielce;7496;6178;6047;131
260906;gm. Obrazów;sandomierski;Kielce;6399;5345;5323;22
260907;gm. Samborzec;sandomierski;Kielce;8544;7118;7062;56
260908;gm. Wilczyce;sandomierski;Kielce;3765;3133;3083;50
260909;gm. Zawichost;sandomierski;Kielce;4412;3657;3581;76
Powiat skarżyski;;;;72987;62060;61636;424
261001;m. Skarżysko-Kamienna;skarżyski;Kielce;43714;37446;37235;211
261002;gm. Bliżyn;skarżyski;Kielce;8045;6833;6772;61
261003;gm. Łączna;skarżyski;Kielce;5152;4203;4149;54
261004;gm. Skarżysko Kościelne;skarżyski;Kielce;6097;5062;5053;9
261005;gm. Suchedniów;skarżyski;Kielce;9979;8516;8427;89
Powiat starachowicki;;;;88125;73660;73074;586
261101;m. Starachowice;starachowicki;Kielce;46835;40011;39865;146
261102;gm. Brody;starachowicki;Kielce;10868;8975;8766;209
261103;gm. Mirzec;starachowicki;Kielce;8315;6801;6727;74
261104;gm. Pawłów;starachowicki;Kielce;15331;12151;12084;67
261105;gm. Wąchock;starachowicki;Kielce;6776;5722;5632;90
Powiat staszowski;;;;72129;59386;58859;527
261201;gm. Bogoria;staszowski;Kielce;7839;6338;6280;58
261202;gm. Łubnice;staszowski;Kielce;4141;3452;3411;41
261203;gm. Oleśnica;staszowski;Kielce;3939;3264;3209;55
261204;gm. Osiek;staszowski;Kielce;7799;6330;6281;49
261205;gm. Połaniec;staszowski;Kielce;11716;9568;9477;91
261206;gm. Rytwiany;staszowski;Kielce;6423;5267;5243;24
261207;gm. Staszów;staszowski;Kielce;25555;21297;21134;163
261208;gm. Szydłów;staszowski;Kielce;4717;3870;3824;46
Powiat włoszczowski;;;;45593;37339;36958;381
261301;gm. Kluczewsko;włoszczowski;Kielce;5316;4269;4245;24
261302;gm. Krasocin;włoszczowski;Kielce;10710;8629;8576;53
261303;gm. Moskorzew;włoszczowski;Kielce;2765;2325;2228;97
261304;gm. Radków;włoszczowski;Kielce;2489;2091;2034;57
261305;gm. Secemin;włoszczowski;Kielce;4842;3980;3929;51
261306;gm. Włoszczowa;włoszczowski;Kielce;19471;16045;15946;99
Miasto na prawach powiatu;;;;;;;
266101;m. Kielce;Kielce;Kielce;183472;151803;150926;877
Powiat bartoszycki;;;;56695;46417;46119;298
280101;m. Bartoszyce;bartoszycki;Elbląg;22614;18805;18758;47
280102;m. Górowo Iławeckie;bartoszycki;Elbląg;3932;3308;3284;24
280103;gm. Bartoszyce;bartoszycki;Elbląg;10801;8642;8555;87
280104;gm. Bisztynek;bartoszycki;Elbląg;6319;5118;5089;29
280105;gm. Górowo Iławeckie;bartoszycki;Elbląg;6802;5465;5416;49
280106;gm. Sępopol;bartoszycki;Elbląg;6227;5079;5017;62
Powiat braniewski;;;;40285;33008;32533;475
280201;m. Braniewo;braniewski;Elbląg;16029;13185;13090;95
280202;gm. Braniewo;braniewski;Elbląg;6014;4832;4774;58
280203;gm. Frombork;braniewski;Elbląg;3583;2983;2897;86
280204;gm. Lelkowo;braniewski;Elbląg;2886;2380;2295;85
280205;gm. Pieniężno;braniewski;Elbląg;6276;5247;5156;91
280206;gm. Płoskinia;braniewski;Elbląg;2560;2035;2010;25
280207;gm. Wilczęta;braniewski;Elbląg;2937;2346;2311;35
Powiat działdowski;;;;64560;51727;51394;333
280301;m. Działdowo;działdowski;Elbląg;20567;16818;16768;50
280302;gm. Działdowo;działdowski;Elbląg;9613;7449;7419;30
280303;gm. Iłowo-Osada;działdowski;Elbląg;7136;5641;5596;45
280304;gm. Lidzbark;działdowski;Elbląg;14229;11471;11333;138
280305;gm. Płośnica;działdowski;Elbląg;5752;4616;4591;25
280306;gm. Rybno;działdowski;Elbląg;7263;5732;5687;45
Powiat elbląski;;;;56751;45328;44890;438
280401;gm. Elbląg;elbląski;Elbląg;7392;5838;5774;64
280402;gm. Godkowo;elbląski;Elbląg;3134;2528;2497;31
280403;gm. Gronowo Elbląskie;elbląski;Elbląg;4991;3945;3921;24
280404;gm. Markusy;elbląski;Elbląg;4099;3161;3138;23
280405;gm. Milejewo;elbląski;Elbląg;3432;2703;2632;71
280406;gm. Młynary;elbląski;Elbląg;4483;3625;3518;107
280407;gm. Pasłęk;elbląski;Elbląg;19026;15363;15320;43
280408;gm. Rychliki;elbląski;Elbląg;3800;3037;3012;25
280409;gm. Tolkmicko;elbląski;Elbląg;6394;5128;5078;50
Powiat ełcki;;;;85994;68900;68319;581
280501;m. Ełk;ełcki;Olsztyn;57012;45886;45670;216
280502;gm. Ełk;ełcki;Olsztyn;11349;8961;8827;134
280503;gm. Kalinowo;ełcki;Olsztyn;6651;5338;5293;45
280504;gm. Prostki;ełcki;Olsztyn;7243;5691;5625;66
280505;gm. Stare Juchy;ełcki;Olsztyn;3739;3024;2904;120
Powiat giżycki;;;;54839;45094;44630;464
280601;m. Giżycko;giżycki;Olsztyn;27465;22912;22803;109
280604;gm. Giżycko;giżycki;Olsztyn;8421;6799;6659;140
280605;gm. Kruklanki;giżycki;Olsztyn;3169;2524;2499;25
280606;gm. Miłki;giżycki;Olsztyn;3830;3081;3040;41
280608;gm. Ryn;giżycki;Olsztyn;5639;4647;4610;37
280610;gm. Wydminy;giżycki;Olsztyn;6315;5131;5019;112
Powiat iławski;;;;90413;71811;71441;370
280701;m. Iława;iławski;Elbląg;31706;25981;25912;69
280702;m. Lubawa;iławski;Elbląg;9840;7655;7623;32
280703;gm. Iława;iławski;Elbląg;12711;9783;9718;65
280704;gm. Kisielice;iławski;Elbląg;6093;4805;4749;56
280705;gm. Lubawa;iławski;Elbląg;10692;8272;8257;15
280706;gm. Susz;iławski;Elbląg;12621;9788;9752;36
280707;gm. Zalewo;iławski;Elbląg;6750;5527;5430;97
Powiat kętrzyński;;;;61052;50531;50305;226
280801;m. Kętrzyn;kętrzyński;Olsztyn;26161;21848;21816;32
280802;gm. Barciany;kętrzyński;Olsztyn;6137;4951;4900;51
280803;gm. Kętrzyn;kętrzyński;Olsztyn;8042;6471;6450;21
280804;gm. Korsze;kętrzyński;Olsztyn;9605;7879;7840;39
280805;gm. Reszel;kętrzyński;Olsztyn;7282;6211;6139;72
280806;gm. Srokowo;kętrzyński;Olsztyn;3825;3171;3160;11
Powiat lidzbarski;;;;40199;32981;32732;249
280901;m. Lidzbark Warmiński;lidzbarski;Elbląg;14901;12397;12351;46
280902;gm. Kiwity;lidzbarski;Elbląg;3334;2717;2674;43
280903;gm. Lidzbark Warmiński;lidzbarski;Elbląg;6657;5396;5353;43
280904;gm. Lubomino;lidzbarski;Elbląg;3656;2848;2827;21
280905;gm. Orneta;lidzbarski;Elbląg;11651;9623;9527;96
Powiat mrągowski;;;;48932;40177;39726;451
281001;m. Mrągowo;mrągowski;Olsztyn;20866;17519;17435;84
281002;gm. Mikołajki;mrągowski;Olsztyn;7873;6458;6363;95
281003;gm. Mrągowo;mrągowski;Olsztyn;7927;6348;6264;84
281004;gm. Piecki;mrągowski;Olsztyn;7594;6100;6029;71
281005;gm. Sorkwity;mrągowski;Olsztyn;4672;3752;3635;117
Powiat nidzicki;;;;32195;26015;25824;191
281101;gm. Janowiec Kościelny;nidzicki;Olsztyn;3234;2584;2516;68
281102;gm. Janowo;nidzicki;Olsztyn;2684;2136;2127;9
281103;gm. Kozłowo;nidzicki;Olsztyn;5949;4678;4639;39
281104;gm. Nidzica;nidzicki;Olsztyn;20328;16617;16542;75
Powiat nowomiejski;;;;43414;34141;33914;227
281201;m. Nowe Miasto Lubawskie;nowomiejski;Elbląg;10276;8382;8296;86
281202;gm. Biskupiec;nowomiejski;Elbląg;9452;7487;7433;54
281203;gm. Grodziczno;nowomiejski;Elbląg;6409;4960;4932;28
281204;gm. Kurzętnik;nowomiejski;Elbląg;9048;6938;6909;29
281205;gm. Nowe Miasto Lubawskie;nowomiejski;Elbląg;8229;6374;6344;30
Powiat olecki;;;;33117;26552;26347;205
281303;gm. Kowale Oleckie;olecki;Olsztyn;4946;3944;3915;29
281304;gm. Olecko;olecki;Olsztyn;20947;16813;16716;97
281305;gm. Świętajno;olecki;Olsztyn;3903;3150;3097;53
281306;gm. Wieliczki;olecki;Olsztyn;3321;2645;2619;26
Powiat olsztyński;;;;123520;98896;97647;1249
281401;gm. Barczewo;olsztyński;Olsztyn;17123;13687;13554;133
281402;gm. Biskupiec;olsztyński;Olsztyn;18093;14913;14872;41
281403;gm. Dobre Miasto;olsztyński;Olsztyn;15438;12535;12490;45
281404;gm. Dywity;olsztyński;Olsztyn;11746;9299;9099;200
281405;gm. Gietrzwałd;olsztyński;Olsztyn;6572;5175;4984;191
281406;gm. Jeziorany;olsztyński;Olsztyn;7533;6085;6042;43
281407;gm. Jonkowo;olsztyński;Olsztyn;7362;5837;5734;103
281408;gm. Kolno;olsztyński;Olsztyn;3197;2619;2599;20
281409;gm. Olsztynek;olsztyński;Olsztyn;13360;10796;10709;87
281410;gm. Purda;olsztyński;Olsztyn;8563;6855;6675;180
281411;gm. Stawiguda;olsztyński;Olsztyn;10516;7924;7754;170
281412;gm. Świątki;olsztyński;Olsztyn;4017;3171;3135;36
Powiat ostródzki;;;;101559;82001;81129;872
281501;m. Ostróda;ostródzki;Elbląg;31426;25887;25721;166
281502;gm. Dąbrówno;ostródzki;Elbląg;4190;3326;3269;57
281503;gm. Grunwald;ostródzki;Elbląg;5527;4323;4261;62
281504;gm. Łukta;ostródzki;Elbląg;4499;3595;3473;122
281505;gm. Małdyty;ostródzki;Elbląg;6148;4977;4904;73
281506;gm. Miłakowo;ostródzki;Elbląg;5381;4340;4302;38
281507;gm. Miłomłyn;ostródzki;Elbląg;4940;4004;3933;71
281508;gm. Morąg;ostródzki;Elbląg;23639;19066;18866;200
281509;gm. Ostróda;ostródzki;Elbląg;15809;12483;12400;83
Powiat piski;;;;54995;44598;44349;249
281601;gm. Biała Piska;piski;Olsztyn;11609;9226;9206;20
281602;gm. Orzysz;piski;Olsztyn;8809;7150;7113;37
281603;gm. Pisz;piski;Olsztyn;26777;21664;21557;107
281604;gm. Ruciane-Nida;piski;Olsztyn;7800;6558;6473;85
Powiat szczycieński;;;;68862;55784;55229;555
281701;m. Szczytno;szczycieński;Olsztyn;22264;18597;18493;104
281702;gm. Dźwierzuty;szczycieński;Olsztyn;6573;5386;5295;91
281703;gm. Jedwabno;szczycieński;Olsztyn;3720;3046;2975;71
281704;gm. Pasym;szczycieński;Olsztyn;5225;4316;4237;79
281705;gm. Rozogi;szczycieński;Olsztyn;5682;4517;4487;30
281706;gm. Szczytno;szczycieński;Olsztyn;12927;10005;9907;98
281707;gm. Świętajno;szczycieński;Olsztyn;5851;4773;4720;53
281708;gm. Wielbark;szczycieński;Olsztyn;6620;5144;5115;29
Powiat gołdapski;;;;26126;20847;20725;122
281801;gm. Banie Mazurskie;gołdapski;Olsztyn;3725;3107;3071;36
281802;gm. Dubeninki;gołdapski;Olsztyn;2962;2366;2348;18
281803;gm. Gołdap;gołdapski;Olsztyn;19439;15374;15306;68
Powiat węgorzewski;;;;22188;18135;17998;137
281901;gm. Budry;węgorzewski;Olsztyn;2920;2375;2358;17
281902;gm. Pozezdrze;węgorzewski;Olsztyn;3261;2671;2622;49
281903;gm. Węgorzewo;węgorzewski;Olsztyn;16007;13089;13018;71
Miasto na prawach powiatu;;;;;;;
286101;m. Elbląg;Elbląg;Elbląg;110327;91547;91180;367
Miasto na prawach powiatu;;;;;;;
286201;m. Olsztyn;Olsztyn;Olsztyn;157946;129340;128080;1260
Powiat chodzieski;;;;45882;36843;36597;246
300101;m. Chodzież;chodzieski;Piła;17807;14730;14637;93
300102;gm. Budzyń;chodzieski;Piła;8367;6568;6537;31
300103;gm. Chodzież;chodzieski;Piła;5943;4653;4617;36
300104;gm. Margonin;chodzieski;Piła;6362;5008;4954;54
300105;gm. Szamocin;chodzieski;Piła;7403;5884;5852;32
Powiat czarnkowsko-trzcianecki;;;;85435;68209;67768;441
300201;m. Czarnków;czarnkowsko-trzcianecki;Piła;10483;8633;8558;75
300202;gm. Czarnków;czarnkowsko-trzcianecki;Piła;11253;8929;8849;80
300203;gm. Drawsko;czarnkowsko-trzcianecki;Piła;5842;4672;4649;23
300204;gm. Krzyż Wielkopolski;czarnkowsko-trzcianecki;Piła;8531;6913;6855;58
300205;gm. Lubasz;czarnkowsko-trzcianecki;Piła;7630;5942;5876;66
300206;gm. Połajewo;czarnkowsko-trzcianecki;Piła;6204;4857;4840;17
300207;gm. Trzcianka;czarnkowsko-trzcianecki;Piła;23365;18626;18544;82
300208;gm. Wieleń;czarnkowsko-trzcianecki;Piła;12127;9637;9597;40
Powiat gnieźnieński;;;;140813;112103;111266;837
300301;m. Gniezno;gnieźnieński;Konin;64986;52958;52683;275
300302;gm. Czerniejewo;gnieźnieński;Konin;7200;5622;5560;62
300303;gm. Gniezno;gnieźnieński;Konin;12135;9101;8913;188
300304;gm. Kiszkowo;gnieźnieński;Konin;5338;4218;4190;28
300305;gm. Kłecko;gnieźnieński;Konin;7451;5865;5836;29
300306;gm. Łubowo;gnieźnieński;Konin;6489;4997;4924;73
300307;gm. Mieleszyn;gnieźnieński;Konin;4002;3072;3039;33
300308;gm. Niechanowo;gnieźnieński;Konin;5967;4588;4559;29
300309;gm. Trzemeszno;gnieźnieński;Konin;13921;11010;10953;57
300310;gm. Witkowo;gnieźnieński;Konin;13324;10672;10609;63
Powiat gostyński;;;;75173;59780;59599;181
300401;gm. Borek Wielkopolski;gostyński;Leszno;7424;5927;5900;27
300402;gm. Gostyń;gostyński;Leszno;27556;22069;22023;46
300403;gm. Krobia;gostyński;Leszno;12899;10210;10196;14
300404;gm. Pępowo;gostyński;Leszno;5960;4718;4690;28
300405;gm. Piaski;gostyński;Leszno;8557;6751;6706;45
300406;gm. Pogorzela;gostyński;Leszno;4988;3961;3956;5
300407;gm. Poniec;gostyński;Leszno;7789;6144;6128;16
Powiat grodziski;;;;51086;39818;39654;164
300501;gm. Granowo;grodziski;Poznań;5058;3916;3887;29
300502;gm. Grodzisk Wielkopolski;grodziski;Poznań;19350;15244;15184;60
300503;gm. Kamieniec;grodziski;Poznań;6625;5150;5138;12
300504;gm. Rakoniewice;grodziski;Poznań;13082;10080;10032;48
300505;gm. Wielichowo;grodziski;Poznań;6971;5428;5413;15
Powiat jarociński;;;;70596;56140;55986;154
300601;gm. Jaraczewo;jarociński;Kalisz;8082;6379;6361;18
300602;gm. Jarocin;jarociński;Kalisz;44887;35873;35798;75
300603;gm. Kotlin;jarociński;Kalisz;7340;5644;5638;6
300604;gm. Żerków;jarociński;Kalisz;10287;8244;8189;55
Powiat kaliski;;;;83135;66785;66423;362
300701;gm. Blizanów;kaliski;Kalisz;10054;8023;7978;45
300702;gm. Brzeziny;kaliski;Kalisz;5826;4663;4629;34
300703;gm. Ceków-Kolonia;kaliski;Kalisz;4788;3843;3818;25
300704;gm. Godziesze Wielkie;kaliski;Kalisz;9610;7571;7522;49
300705;gm. Koźminek;kaliski;Kalisz;7558;6084;6066;18
300706;gm. Lisków;kaliski;Kalisz;5222;4244;4231;13
300707;gm. Mycielin;kaliski;Kalisz;4876;3953;3919;34
300708;gm. Opatówek;kaliski;Kalisz;10665;8685;8653;32
300709;gm. Stawiszyn;kaliski;Kalisz;7158;5800;5769;31
300710;gm. Szczytniki;kaliski;Kalisz;7833;6279;6241;38
300711;gm. Żelazków;kaliski;Kalisz;9545;7640;7597;43
Powiat kępiński;;;;55661;44537;44266;271
300801;gm. Baranów;kępiński;Kalisz;8001;6304;6274;30
300802;gm. Bralin;kępiński;Kalisz;6071;4766;4727;39
300803;gm. Kępno;kępiński;Kalisz;23787;19235;19121;114
300804;gm. Łęka Opatowska;kępiński;Kalisz;5329;4176;4152;24
300805;gm. Perzów;kępiński;Kalisz;3766;3029;3007;22
300806;gm. Rychtal;kępiński;Kalisz;3802;3093;3066;27
300807;gm. Trzcinica;kępiński;Kalisz;4905;3934;3919;15
Powiat kolski;;;;86071;70050;69671;379
300901;m. Koło;kolski;Konin;21112;17477;17389;88
300902;gm. Babiak;kolski;Konin;7865;6406;6356;50
300903;gm. Chodów;kolski;Konin;3101;2614;2608;6
300904;gm. Dąbie;kolski;Konin;6306;5183;5160;23
300905;gm. Grzegorzew;kolski;Konin;5694;4573;4532;41
300906;gm. Kłodawa;kolski;Konin;12636;10403;10362;41
300907;gm. Koło;kolski;Konin;7766;6176;6140;36
300908;gm. Kościelec;kolski;Konin;6759;5389;5348;41
300909;gm. Olszówka;kolski;Konin;4530;3665;3657;8
300910;gm. Osiek Mały;kolski;Konin;6154;4820;4806;14
300911;gm. Przedecz;kolski;Konin;4148;3344;3313;31
Powiat koniński;;;;129370;103521;102743;778
301001;gm. Golina;koniński;Konin;11997;9725;9642;83
301002;gm. Grodziec;koniński;Konin;5235;4128;4100;28
301003;gm. Kazimierz Biskupi;koniński;Konin;11391;9161;9105;56
301004;gm. Kleczew;koniński;Konin;9801;7989;7934;55
301005;gm. Kramsk;koniński;Konin;11194;8940;8885;55
301006;gm. Krzymów;koniński;Konin;7997;6313;6265;48
301007;gm. Rychwał;koniński;Konin;8229;6613;6541;72
301008;gm. Rzgów;koniński;Konin;7226;5800;5775;25
301009;gm. Skulsk;koniński;Konin;6130;4936;4858;78
301010;gm. Sompolno;koniński;Konin;10477;8373;8350;23
301011;gm. Stare Miasto;koniński;Konin;12260;9525;9455;70
301012;gm. Ślesin;koniński;Konin;14010;11385;11303;82
301013;gm. Wierzbinek;koniński;Konin;7243;5730;5678;52
301014;gm. Wilczyn;koniński;Konin;6180;4903;4852;51
Powiat kościański;;;;77065;62046;61726;320
301101;m. Kościan;kościański;Leszno;22650;18779;18637;142
301102;gm. Czempiń;kościański;Leszno;11249;9059;8998;61
301103;gm. Kościan;kościański;Leszno;15924;12625;12594;31
301104;gm. Krzywiń;kościański;Leszno;9878;7851;7795;56
301105;gm. Śmigiel;kościański;Leszno;17364;13732;13702;30
Powiat krotoszyński;;;;75949;60689;60505;184
301201;m. Sulmierzyce;krotoszyński;Kalisz;2839;2242;2225;17
301202;gm. Kobylin;krotoszyński;Kalisz;8046;6375;6346;29
301203;gm. Koźmin Wielkopolski;krotoszyński;Kalisz;13229;10572;10559;13
301204;gm. Krotoszyn;krotoszyński;Kalisz;39179;31653;31574;79
301205;gm. Rozdrażew;krotoszyński;Kalisz;5207;4058;4049;9
301206;gm. Zduny;krotoszyński;Kalisz;7449;5789;5752;37
Powiat leszczyński;;;;56530;43976;43593;383
301301;gm. Krzemieniewo;leszczyński;Leszno;8317;6581;6553;28
301302;gm. Lipno;leszczyński;Leszno;8218;6302;6146;156
301303;gm. Osieczna;leszczyński;Leszno;9117;7195;7147;48
301304;gm. Rydzyna;leszczyński;Leszno;9497;7392;7317;75
301305;gm. Święciechowa;leszczyński;Leszno;7991;6200;6189;11
301306;gm. Wijewo;leszczyński;Leszno;3806;2928;2894;34
301307;gm. Włoszakowice;leszczyński;Leszno;9584;7378;7347;31
Powiat międzychodzki;;;;36144;28915;28518;397
301401;gm. Chrzypsko Wielkie;międzychodzki;Poznań;3306;2632;2533;99
301402;gm. Kwilcz;międzychodzki;Poznań;6357;5005;4867;138
301403;gm. Międzychód;międzychodzki;Poznań;17841;14417;14318;99
301404;gm. Sieraków;międzychodzki;Poznań;8640;6861;6800;61
Powiat nowotomyski;;;;74108;58191;57841;350
301501;gm. Kuślin;nowotomyski;Poznań;5446;4276;4239;37
301502;gm. Lwówek;nowotomyski;Poznań;9010;7116;7046;70
301503;gm. Miedzichowo;nowotomyski;Poznań;3739;2965;2932;33
301504;gm. Nowy Tomyśl;nowotomyski;Poznań;26223;20526;20387;139
301505;gm. Opalenica;nowotomyski;Poznań;16118;12592;12556;36
301506;gm. Zbąszyń;nowotomyski;Poznań;13572;10716;10681;35
Powiat obornicki;;;;57279;45195;44817;378
301601;gm. Oborniki;obornicki;Poznań;32713;25833;25621;212
301602;gm. Rogoźno;obornicki;Poznań;17402;13732;13603;129
301603;gm. Ryczywół;obornicki;Poznań;7164;5630;5593;37
Powiat ostrowski;;;;158181;127758;127369;389
301701;m. Ostrów Wielkopolski;ostrowski;Kalisz;69028;57097;56924;173
301702;gm. Nowe Skalmierzyce;ostrowski;Kalisz;15450;12278;12255;23
301703;gm. Odolanów;ostrowski;Kalisz;14734;11616;11572;44
301704;gm. Ostrów Wielkopolski;ostrowski;Kalisz;18920;15019;14991;28
301705;gm. Przygodzice;ostrowski;Kalisz;12077;9626;9595;31
301706;gm. Raszków;ostrowski;Kalisz;11735;9261;9247;14
301707;gm. Sieroszewice;ostrowski;Kalisz;9677;7634;7616;18
301708;gm. Sośnie;ostrowski;Kalisz;6560;5227;5169;58
Powiat ostrzeszowski;;;;55040;44000;43654;346
301801;gm. Czajków;ostrzeszowski;Kalisz;2531;2054;2034;20
301802;gm. Doruchów;ostrzeszowski;Kalisz;5404;4240;4220;20
301803;gm. Grabów nad Prosną;ostrzeszowski;Kalisz;7823;6287;6234;53
301804;gm. Kobyla Góra;ostrzeszowski;Kalisz;6069;4792;4743;49
301805;gm. Kraszewice;ostrzeszowski;Kalisz;3606;2851;2834;17
301806;gm. Mikstat;ostrzeszowski;Kalisz;6063;4865;4831;34
301807;gm. Ostrzeszów;ostrzeszowski;Kalisz;23544;18911;18758;153
Powiat pilski;;;;130700;105386;104526;860
301901;m. Piła;pilski;Piła;68533;56221;55697;524
301902;gm. Białośliwie;pilski;Piła;4706;3745;3711;34
301903;gm. Kaczory;pilski;Piła;7785;6114;6051;63
301904;gm. Łobżenica;pilski;Piła;9451;7424;7394;30
301905;gm. Miasteczko Krajeńskie;pilski;Piła;3190;2517;2482;35
301906;gm. Szydłowo;pilski;Piła;8943;6991;6917;74
301907;gm. Ujście;pilski;Piła;7791;6308;6263;45
301908;gm. Wyrzysk;pilski;Piła;13784;10929;10904;25
301909;gm. Wysoka;pilski;Piła;6517;5137;5107;30
Powiat pleszewski;;;;61614;49453;48854;599
302001;gm. Chocz;pleszewski;Kalisz;4753;3861;3828;33
302002;gm. Czermin;pleszewski;Kalisz;4923;3830;3790;40
302003;gm. Dobrzyca;pleszewski;Kalisz;8121;6382;6374;8
302004;gm. Gizałki;pleszewski;Kalisz;4590;3639;3557;82
302005;gm. Gołuchów;pleszewski;Kalisz;10719;8446;8414;32
302006;gm. Pleszew;pleszewski;Kalisz;28508;23295;22891;404
Powiat poznański;;;;381353;293331;288129;5202
302101;m. Luboń;poznański;Poznań;30039;23691;23476;215
302102;m. Puszczykowo;poznański;Poznań;9304;7806;7523;283
302103;gm. Buk;poznański;Poznań;12293;9716;9651;65
302104;gm. Czerwonak;poznański;Poznań;26200;20716;20440;276
302105;gm. Dopiewo;poznański;Poznań;26567;19555;18876;679
302106;gm. Kleszczewo;poznański;Poznań;8434;6226;6105;121
302107;gm. Komorniki;poznański;Poznań;28902;20877;20437;440
302108;gm. Kostrzyn;poznański;Poznań;18040;14213;14078;135
302109;gm. Kórnik;poznański;Poznań;27948;21000;20611;389
302110;gm. Mosina;poznański;Poznań;32064;24866;24583;283
302111;gm. Murowana Goślina;poznański;Poznań;16429;13105;12884;221
302112;gm. Pobiedziska;poznański;Poznań;19234;15196;14819;377
302113;gm. Rokietnica;poznański;Poznań;17572;13237;12845;392
302114;gm. Stęszew;poznański;Poznań;14894;11908;11810;98
302115;gm. Suchy Las;poznański;Poznań;17250;13053;12796;257
302116;gm. Swarzędz;poznański;Poznań;48627;37551;37087;464
302117;gm. Tarnowo Podgórne;poznański;Poznań;27556;20615;20108;507
Powiat rawicki;;;;59448;46997;46806;191
302201;gm. Bojanowo;rawicki;Leszno;8699;6829;6819;10
302202;gm. Jutrosin;rawicki;Leszno;7135;5521;5511;10
302203;gm. Miejska Górka;rawicki;Leszno;9269;7322;7288;34
302204;gm. Pakosław;rawicki;Leszno;4878;3720;3698;22
302205;gm. Rawicz;rawicki;Leszno;29467;23605;23490;115
Powiat słupecki;;;;58900;47620;47223;397
302301;m. Słupca;słupecki;Konin;13242;10868;10824;44
302302;gm. Lądek;słupecki;Konin;5785;4675;4612;63
302303;gm. Orchowo;słupecki;Konin;3855;3048;3025;23
302304;gm. Ostrowite;słupecki;Konin;5163;4219;4190;29
302305;gm. Powidz;słupecki;Konin;2282;1871;1795;76
302306;gm. Słupca;słupecki;Konin;9612;7661;7624;37
302307;gm. Strzałkowo;słupecki;Konin;10091;8047;8012;35
302308;gm. Zagórów;słupecki;Konin;8870;7231;7141;90
Powiat szamotulski;;;;88843;70687;70007;680
302401;m. Obrzycko;szamotulski;Poznań;2406;1887;1852;35
302402;gm. Duszniki;szamotulski;Poznań;9022;7116;7008;108
302403;gm. Kaźmierz;szamotulski;Poznań;8451;6563;6513;50
302404;gm. Obrzycko;szamotulski;Poznań;4425;3476;3414;62
302405;gm. Ostroróg;szamotulski;Poznań;4868;3877;3826;51
302406;gm. Pniewy;szamotulski;Poznań;12280;9751;9638;113
302407;gm. Szamotuły;szamotulski;Poznań;28974;23232;23091;141
302408;gm. Wronki;szamotulski;Poznań;18417;14785;14665;120
Powiat średzki;;;;57310;45208;44873;335
302501;gm. Dominowo;średzki;Konin;3046;2368;2350;18
302502;gm. Krzykosy;średzki;Konin;7012;5465;5448;17
302503;gm. Nowe Miasto nad Wartą;średzki;Konin;9001;7131;7107;24
302504;gm. Środa Wielkopolska;średzki;Konin;31531;24904;24708;196
302505;gm. Zaniemyśl;średzki;Konin;6720;5340;5260;80
Powiat śremski;;;;59486;47183;46853;330
302601;gm. Brodnica;śremski;Konin;4812;3785;3732;53
302602;gm. Dolsk;śremski;Konin;5827;4596;4558;38
302603;gm. Książ Wielkopolski;śremski;Konin;8397;6579;6565;14
302604;gm. Śrem;śremski;Konin;40450;32223;31998;225
Powiat turecki;;;;83244;67001;66559;442
302701;m. Turek;turecki;Konin;26142;21894;21808;86
302702;gm. Brudzew;turecki;Konin;5982;4779;4751;28
302703;gm. Dobra;turecki;Konin;6087;4851;4815;36
302704;gm. Kawęczyn;turecki;Konin;5360;4280;4254;26
302705;gm. Malanów;turecki;Konin;6606;5244;5209;35
302706;gm. Przykona;turecki;Konin;4595;3625;3585;40
302707;gm. Tuliszków;turecki;Konin;10549;8329;8234;95
302708;gm. Turek;turecki;Konin;9834;7608;7564;44
302709;gm. Władysławów;turecki;Konin;8089;6391;6339;52
Powiat wągrowiecki;;;;68485;54206;53859;347
302801;m. Wągrowiec;wągrowiecki;Piła;24461;19907;19762;145
302802;gm. Damasławek;wągrowiecki;Piła;5390;4250;4224;26
302803;gm. Gołańcz;wągrowiecki;Piła;8176;6349;6319;30
302804;gm. Mieścisko;wągrowiecki;Piła;5951;4697;4670;27
302805;gm. Skoki;wągrowiecki;Piła;9390;7316;7251;65
302806;gm. Wapno;wągrowiecki;Piła;2972;2369;2351;18
302807;gm. Wągrowiec;wągrowiecki;Piła;12145;9318;9282;36
Powiat wolsztyński;;;;56454;44293;44041;252
302901;gm. Przemęt;wolsztyński;Poznań;14160;11026;10975;51
302902;gm. Siedlec;wolsztyński;Poznań;12592;9714;9674;40
302903;gm. Wolsztyn;wolsztyński;Poznań;29702;23553;23392;161
Powiat wrzesiński;;;;75285;60044;59799;245
303001;gm. Kołaczkowo;wrzesiński;Konin;5957;4665;4651;14
303002;gm. Miłosław;wrzesiński;Konin;10139;8117;8064;53
303003;gm. Nekla;wrzesiński;Konin;7364;5842;5797;45
303004;gm. Pyzdry;wrzesiński;Konin;6982;5611;5542;69
303005;gm. Września;wrzesiński;Konin;44843;35809;35745;64
Powiat złotowski;;;;67843;53958;53681;277
303101;m. Złotów;złotowski;Piła;17648;14399;14351;48
303102;gm. Jastrowie;złotowski;Piła;11127;8803;8780;23
303103;gm. Krajenka;złotowski;Piła;7451;5871;5848;23
303104;gm. Lipka;złotowski;Piła;5515;4331;4309;22
303105;gm. Okonek;złotowski;Piła;8490;6833;6802;31
303106;gm. Tarnówka;złotowski;Piła;3072;2383;2334;49
303107;gm. Zakrzewo;złotowski;Piła;4979;3964;3918;46
303108;gm. Złotów;złotowski;Piła;9561;7374;7339;35
Miasto na prawach powiatu;;;;;;;
306101;m. Kalisz;Kalisz;Kalisz;94022;78109;77730;379
Miasto na prawach powiatu;;;;;;;
306201;m. Konin;Konin;Konin;69876;58886;58725;161
Miasto na prawach powiatu;;;;;;;
306301;m. Leszno;Leszno;Leszno;59815;48958;48723;235
Miasto na prawach powiatu;;;;;;;
306401;m. Poznań;Poznań;Poznań;480996;395094;388162;6932
Powiat białogardzki;;;;44934;36543;36194;349
320101;m. Białogard;białogardzki;Koszalin;22223;18316;18134;182
320102;gm. Białogard;białogardzki;Koszalin;7347;5940;5888;52
320103;gm. Karlino;białogardzki;Koszalin;8753;6996;6953;43
320104;gm. Tychowo;białogardzki;Koszalin;6611;5291;5219;72
Powiat choszczeński;;;;46706;38162;37877;285
320201;gm. Bierzwnik;choszczeński;Koszalin;4721;3820;3775;45
320202;gm. Choszczno;choszczeński;Koszalin;20502;16839;16724;115
320203;gm. Drawno;choszczeński;Koszalin;4971;4155;4099;56
320204;gm. Krzęcin;choszczeński;Koszalin;3593;2925;2900;25
320205;gm. Pełczyce;choszczeński;Koszalin;7632;6111;6099;12
320206;gm. Recz;choszczeński;Koszalin;5287;4312;4280;32
Powiat drawski;;;;55914;45398;44933;465
320301;gm. Czaplinek;drawski;Koszalin;11552;9407;9308;99
320302;gm. Drawsko Pomorskie;drawski;Koszalin;16995;13853;13717;136
320303;gm. Kalisz Pomorski;drawski;Koszalin;7055;5623;5552;71
320305;gm. Wierzchowo;drawski;Koszalin;4299;3483;3457;26
320306;gm. Złocieniec;drawski;Koszalin;16013;13032;12899;133
Powiat goleniowski;;;;78373;63269;62537;732
320402;gm. Goleniów;goleniowski;Szczecin;34062;27421;27230;191
320403;gm. Maszewo;goleniowski;Szczecin;8526;6765;6598;167
320404;gm. Nowogard;goleniowski;Szczecin;23258;18969;18741;228
320405;gm. Osina;goleniowski;Szczecin;2941;2360;2311;49
320406;gm. Przybiernów;goleniowski;Szczecin;4893;3977;3944;33
320407;gm. Stepnica;goleniowski;Szczecin;4693;3777;3713;64
Powiat gryficki;;;;58109;47415;46623;792
320501;gm. Brojce;gryficki;Szczecin;3741;2921;2893;28
320502;gm. Gryfice;gryficki;Szczecin;22590;18494;18262;232
320503;gm. Karnice;gryficki;Szczecin;3988;3276;3166;110
320504;gm. Płoty;gryficki;Szczecin;8714;7020;6939;81
320507;gm. Rewal;gryficki;Szczecin;3660;3211;2979;232
320508;gm. Trzebiatów;gryficki;Szczecin;15416;12493;12384;109
Powiat gryfiński;;;;79256;64472;63810;662
320601;gm. Banie;gryfiński;Szczecin;6167;5023;4996;27
320602;gm. Cedynia;gryfiński;Szczecin;4242;3454;3346;108
320603;gm. Chojna;gryfiński;Szczecin;13315;10822;10725;97
320604;gm. Gryfino;gryfiński;Szczecin;29998;24474;24340;134
320605;gm. Mieszkowice;gryfiński;Szczecin;6963;5575;5560;15
320606;gm. Moryń;gryfiński;Szczecin;4249;3421;3369;52
320607;gm. Stare Czarnowo;gryfiński;Szczecin;3737;3071;2966;105
320608;gm. Trzcińsko-Zdrój;gryfiński;Szczecin;5320;4353;4267;86
320609;gm. Widuchowa;gryfiński;Szczecin;5265;4279;4241;38
Powiat kamieński;;;;45119;37568;36879;689
320701;gm. Dziwnów;kamieński;Szczecin;3768;3217;3106;111
320702;gm. Golczewo;kamieński;Szczecin;5692;4756;4682;74
320703;gm. Kamień Pomorski;kamieński;Szczecin;13619;11455;11329;126
320704;gm. Międzyzdroje;kamieński;Szczecin;6110;5116;4973;143
320705;gm. Świerzno;kamieński;Szczecin;4116;3339;3294;45
320706;gm. Wolin;kamieński;Szczecin;11814;9685;9495;190
Powiat kołobrzeski;;;;74762;62079;60932;1147
320801;m. Kołobrzeg;kołobrzeski;Koszalin;41908;35657;35141;516
320802;gm. Dygowo;kołobrzeski;Koszalin;5438;4377;4321;56
320803;gm. Gościno;kołobrzeski;Koszalin;5242;4159;4096;63
320804;gm. Kołobrzeg;kołobrzeski;Koszalin;10742;8672;8391;281
320805;gm. Rymań;kołobrzeski;Koszalin;3938;3206;3169;37
320806;gm. Siemyśl;kołobrzeski;Koszalin;3763;2958;2935;23
320807;gm. Ustronie Morskie;kołobrzeski;Koszalin;3731;3050;2879;171
Powiat koszaliński;;;;64554;52147;51052;1095
320901;gm. Będzino;koszaliński;Koszalin;8358;6769;6718;51
320902;gm. Biesiekierz;koszaliński;Koszalin;6876;5408;5292;116
320903;gm. Bobolice;koszaliński;Koszalin;8725;7078;7006;72
320904;gm. Manowo;koszaliński;Koszalin;6481;5225;5091;134
320905;gm. Mielno;koszaliński;Koszalin;4771;4017;3843;174
320906;gm. Polanów;koszaliński;Koszalin;8454;6797;6709;88
320907;gm. Sianów;koszaliński;Koszalin;13570;10973;10749;224
320908;gm. Świeszyno;koszaliński;Koszalin;7319;5880;5644;236
Powiat myśliborski;;;;63191;51517;51184;333
321001;gm. Barlinek;myśliborski;Szczecin;18334;14947;14897;50
321002;gm. Boleszkowice;myśliborski;Szczecin;2827;2267;2247;20
321003;gm. Dębno;myśliborski;Szczecin;19562;15835;15706;129
321004;gm. Myślibórz;myśliborski;Szczecin;19055;15795;15734;61
321005;gm. Nowogródek Pomorski;myśliborski;Szczecin;3413;2673;2600;73
Powiat policki;;;;73583;58718;57681;1037
321101;gm. Dobra (Szczecińska);policki;Szczecin;22218;17052;16596;456
321102;gm. Kołbaskowo;policki;Szczecin;12149;9394;9183;211
321103;gm. Nowe Warpno;policki;Szczecin;1563;1327;1256;71
321104;gm. Police;policki;Szczecin;37653;30945;30646;299
Powiat pyrzycki;;;;38042;31073;30779;294
321201;gm. Bielice;pyrzycki;Szczecin;3058;2439;2386;53
321202;gm. Kozielice;pyrzycki;Szczecin;2567;2048;2035;13
321203;gm. Lipiany;pyrzycki;Szczecin;5776;4714;4678;36
321204;gm. Przelewice;pyrzycki;Szczecin;5031;4075;4043;32
321205;gm. Pyrzyce;pyrzycki;Szczecin;18229;15032;14904;128
321206;gm. Warnice;pyrzycki;Szczecin;3381;2765;2733;32
Powiat sławieński;;;;54240;44137;43613;524
321301;m. Darłowo;sławieński;Koszalin;12780;10769;10670;99
321302;m. Sławno;sławieński;Koszalin;11782;9692;9592;100
321303;gm. Darłowo;sławieński;Koszalin;7839;6327;6241;86
321304;gm. Malechowo;sławieński;Koszalin;6299;5081;4972;109
321305;gm. Postomino;sławieński;Koszalin;6915;5453;5358;95
321306;gm. Sławno;sławieński;Koszalin;8625;6815;6780;35
Powiat stargardzki;;;;113414;92671;91669;1002
321401;m. Stargard;stargardzki;Szczecin;62213;51586;51356;230
321402;gm. Chociwel;stargardzki;Szczecin;5776;4685;4597;88
321403;gm. Dobrzany;stargardzki;Szczecin;4715;3918;3865;53
321404;gm. Dolice;stargardzki;Szczecin;7612;6090;6044;46
321405;gm. Ińsko;stargardzki;Szczecin;3399;2855;2770;85
321406;gm. Kobylanka;stargardzki;Szczecin;5510;4440;4246;194
321408;gm. Marianowo;stargardzki;Szczecin;3038;2445;2397;48
321409;gm. Stara Dąbrowa;stargardzki;Szczecin;3711;2901;2845;56
321410;gm. Stargard;stargardzki;Szczecin;13320;10392;10223;169
321411;gm. Suchań;stargardzki;Szczecin;4120;3359;3326;33
Powiat szczecinecki;;;;73801;60473;59792;681
321501;m. Szczecinek;szczecinecki;Koszalin;36859;30578;30420;158
321502;gm. Barwice;szczecinecki;Koszalin;8431;6807;6760;47
321503;gm. Biały Bór;szczecinecki;Koszalin;5130;4177;4112;65
321504;gm. Borne Sulinowo;szczecinecki;Koszalin;9401;7691;7461;230
321505;gm. Grzmiąca;szczecinecki;Koszalin;4780;3915;3864;51
321506;gm. Szczecinek;szczecinecki;Koszalin;9200;7305;7175;130
Powiat świdwiński;;;;45442;37288;36944;344
321601;m. Świdwin;świdwiński;Koszalin;14697;12033;11913;120
321602;gm. Brzeżno;świdwiński;Koszalin;2705;2169;2146;23
321603;gm. Połczyn-Zdrój;świdwiński;Koszalin;14612;12223;12136;87
321604;gm. Rąbino;świdwiński;Koszalin;3630;2907;2879;28
321605;gm. Sławoborze;świdwiński;Koszalin;3952;3232;3181;51
321606;gm. Świdwin;świdwiński;Koszalin;5846;4724;4689;35
Powiat wałecki;;;;50797;41413;41071;342
321701;m. Wałcz;wałecki;Koszalin;23464;19511;19438;73
321702;gm. Człopa;wałecki;Koszalin;4957;4003;3927;76
321703;gm. Mirosławiec;wałecki;Koszalin;5241;4179;4092;87
321704;gm. Tuczno;wałecki;Koszalin;4799;3878;3822;56
321705;gm. Wałcz;wałecki;Koszalin;12336;9842;9792;50
Powiat łobeski;;;;35219;28800;28447;353
321801;gm. Dobra;łobeski;Szczecin;4193;3419;3350;69
321802;gm. Łobez;łobeski;Szczecin;13095;10809;10723;86
321803;gm. Radowo Małe;łobeski;Szczecin;3519;2909;2870;39
321804;gm. Resko;łobeski;Szczecin;7617;6110;6042;68
321805;gm. Węgorzyno;łobeski;Szczecin;6795;5553;5462;91
Miasto na prawach powiatu;;;;;;;
326101;m. Koszalin;Koszalin;Koszalin;99069;82155;81393;762
Miasto na prawach powiatu;;;;;;;
326201;m. Szczecin;Szczecin;Szczecin;358892;297067;294360;2707
Miasto na prawach powiatu;;;;;;;
326301;m. Świnoujście;Świnoujście;Szczecin;37347;31743;31337;406
Suma;;;;36872010;29936783;29597439;339344
